Athlete	CountryCode	Sport	Medals
aage larsen, ebbe parsner	DEN	Rowing	1
aaron peirsol	USA	Swimming	5
aaron peirsol, michael phelps, jason lezak, ian crocker, brendan hansen, matt grevers, mark gangloff, garrett weber-gale	USA	Swimming	1
a b bailey, phil boyd, george strange, pat reiffenstein, colonel rice, thomas loudon, donald mackenzie, william wadsworth, joseph wright	CAN	Rowing	1
abdalaati iguider	MAR	Athletics	1
abdon pamich	ITA	Athletics	2
abdoulaye seye	FRA	Athletics	1
abebe bikila	ETH	Athletics	2
abel kiprop mutai	KEN	Athletics	1
abel kirui	KEN	Athletics	1
abel kiviat	USA	Athletics	1
achim hill	GER	Rowing	2
ada kok	NED	Swimming	2
adalberts bubenko	LAT	Athletics	1
adamski, kuffner, johannesen, reinelt, schmidt, mueller, mennigen, wilke, sauer	GER	Rowing	1
adam van koeverden	CAN	Canoeing	4
addis abebe	ETH	Athletics	1
adolph kiefer	USA	Swimming	1
adriana bazon-chelariu, lulia bobeica, elena georgescu, viorica lepadatu, viorica neculai, ioana olteanu, maria paduraru, doina robu	ROM	Rowing	1
adrian moorhouse	GBR	Swimming	1
agnes geraghty	USA	Swimming	1
agneta andersson	SWE	Canoeing	1
agneta andersson, anna olsson	SWE	Canoeing	1
agneta andersson, ingela ericsson, susanne rosenqvist, anna olsson	SWE	Canoeing	1
agneta andersson, susanne gunnarsson-wiberg	SWE	Canoeing	1
agneta andersson, susanne gunnarsson-wiberg, eva karlsson, anna olsson	SWE	Canoeing	1
agnieszka czopek	POL	Swimming	1
agostino abbagnale, davide tizzano	ITA	Rowing	1
ahmed salah	DJI	Athletics	1
aigars fadejevs	LAT	Athletics	1
aileen meagher, mildred dolson, hilda cameron, dorothy brookshaw	CAN	Athletics	1
aileen riggin	USA	Swimming	1
aina berg, wivan pettersson, gurli everlund, hj?rdis t?pel	SWE	Swimming	1
ai shibata	JPN	Swimming	1
aissa djabir said-guerni	ALG	Athletics	1
akos vereckei, botond storcz, zoltan kammerer, g?bor horv?th	HUN	Canoeing	1
alain bernard	FRA	Swimming	2
alain lebas	FRA	Canoeing	1
alain mimoun	FRA	Athletics	4
alain mosconi	FRA	Swimming	1
alajos szokolyi	HUN	Athletics	1
alan campbell	GBR	Rowing	1
alan ford	USA	Swimming	1
alan grover, alfred duval, joseph fazio, peter dickson, david douglas, robert shirlaw, michael morgan, gary pearce, john ranch	AUS	Rowing	1
alan mcclatchey, brian brinkley, gordon downie, david dunne	GBR	Swimming	1
alan pascoe, martin reynolds, david jenkins, david hemery	GBR	Athletics	1
alan thompson	NZL	Canoeing	1
albert coray	USA	Athletics	1
albert hill	GBR	Athletics	2
alberto cova	ITA	Athletics	1
alberto demiddi	ARG	Rowing	2
alberto juantorena	CUB	Athletics	2
alberto zorrilla	ARG	Swimming	1
albert schwartz	USA	Swimming	1
albert vandeweghe	USA	Swimming	1
albina osipowich	USA	Swimming	1
albin lermusiaux	FRA	Athletics	1
albin stenroos	FIN	Athletics	2
alb?n vermes	HUN	Swimming	1
alejandro casa?as	CUB	Athletics	2
aleksandra fedoriva, yulia gushchina, yuliya chermoshanskaya, evgeniya polyakova	RUS	Athletics	1
aleksandra gerasimenya	BLR	Swimming	2
aleksandr anufriyev	URS	Athletics	1
aleksandr berkutov, yury tyukalov	URS	Rowing	2
aleksandr chayev	URS	Swimming	1
aleksandr lukyanov, viktor omelyanovich, vasily tikhonov, andrey vasilyev, aleksandr dumchev, viktor diduk, veniamin but, nikolay komarov, pavel gurkovsky	URS	Rowing	1
aleksandr maseykov, dmitry dovgalenok	URS	Canoeing	1
aleksandr popov	RUS	Swimming	3
aleksandr popov	URS	Swimming	2
aleksandr puchkov	URS	Athletics	1
aleksandr rogov	URS	Canoeing	1
aleksandr shaparenko	URS	Canoeing	2
aleksandr sidorenko	URS	Swimming	1
aleksandr silayev	URS	Canoeing	1
aleksandr vinogradov, sergey petrenko	URS	Canoeing	1
aleksey kudryavtsev, dmitry lepikov, vladimir pyshnenko, yury mukhin, veniamin tayanovich, yevgeny sadovyi	URS	Swimming	1
aleksey voyevodin	RUS	Athletics	1
alessandro lambruschini	ITA	Athletics	1
alessia filippi	ITA	Swimming	1
alessio sartori, romano battisti	ITA	Rowing	1
alessio sartori, rossano galtarossa	ITA	Rowing	1
alexander daleoen	NOR	Swimming	1
alexander kostoglod, alexander kovalev	RUS	Canoeing	2
alexander luderitz, mark pinger, bengt zikarsky, bj?rn zikarsky, christian tr?ger	GER	Swimming	1
alexander mcculloch	GBR	Rowing	1
alexander wilson	CAN	Athletics	2
alexander wilson, raymond lewis, james ball, philip edwards	CAN	Athletics	1
alexander wilson, stanley glover, philip edwards, james ball	CAN	Athletics	1
alexandra barr?, sue holloway	CAN	Canoeing	1
alexandra tsiavou, christina giazitzidou	GRE	Rowing	1
alexandre jany, aldo eminente, jean boiteux, joseph bernardo	FRA	Swimming	1
alexandre jany, henri padou, ren? cornu, joseph bernardo	FRA	Swimming	1
alex baumann	CAN	Swimming	2
alexe dumitru, simion ismailciuc	ROM	Canoeing	1
alexey korovashkov, ilya pervukhin	RUS	Canoeing	1
alex schwazer	ITA	Athletics	1
alf hansen, frank hansen	NOR	Rowing	1
alf hansen, lars bj?nness, vetle vinje, rolf thorsen	NOR	Rowing	1
alfons dorfner, adolf kainz	AUT	Canoeing	1
alfr?d haj?s	HUN	Swimming	1
alfred bachmann, heinrich fischer	SUI	Rowing	1
alfred dompert	GER	Athletics	1
alfred healey	GBR	Athletics	1
alfred sageder, josef kloimstein	AUT	Rowing	1
alfred tysoe	GBR	Athletics	1
alfred wilson, howard kingsbury, leonard carpenter, john miller, al lindley, james rockefeller, benjamin spock, laurence stoddard, frederick sheffield	USA	Rowing	1
alfred yego	KEN	Athletics	1
aliaksandr bahdanovich, andrei bahdanovich	BLR	Canoeing	2
aliaksei abalmasau, raman piatrushenka, vadzim makhneu, artur litvinchuk	BLR	Canoeing	1
alice bridges	USA	Swimming	1
alice brown	USA	Athletics	1
alice mills, petria thomas, giaan rooney, brooke hanson, jodie henry, leisel jones, jessicah schipper	AUS	Swimming	1
alicia coutts	AUS	Swimming	2
ali ezzine	MAR	Athletics	1
ali saidi-sief	ALG	Athletics	1
allan lawrence	AUS	Athletics	1
allan wells	GBR	Athletics	2
allan wood	AUS	Swimming	2
allen johnson	USA	Athletics	1
allen stack	USA	Swimming	1
allen woodring	USA	Athletics	1
allison schmitt	USA	Swimming	2
allison wagner	USA	Swimming	1
allyson felix	USA	Athletics	3
allyson felix, deedee trotter, sanya richards-ross, francena mccorory	USA	Athletics	1
allyson felix, tianna madison, bianca knight, carmelita jeter	USA	Athletics	1
alonzo babers	USA	Athletics	1
alva colqhoun, lorraine crapp, dawn fraser, ilsa konrads	AUS	Swimming	1
alvah meyer	USA	Athletics	1
alvin harrison	USA	Athletics	1
alvin harrison, derek mills, lamont smith, anthuan maybank	USA	Athletics	1
alvin kraenzlein	USA	Athletics	1
alwyn morris, hugh fisher	CAN	Canoeing	1
amadou dia b?	SEN	Athletics	1
amanda beard	USA	Swimming	5
amaury leveaux	FRA	Swimming	1
amaury leveaux, clement lefert, gregory mallet, yannick agnel	FRA	Swimming	1
ambrose gaines	USA	Swimming	1
amos biwott	KEN	Athletics	1
amy van dyken	USA	Swimming	2
amy van dyken, jenny thompson, angel martino, kristine quance, catherine fox, amanda beard, beth botsford, whitney hedgepeth	USA	Swimming	1
amy white	USA	Swimming	1
ana guevara	MEX	Athletics	1
ana quirot	CUB	Athletics	2
anastasia zueva	RUS	Swimming	1
anatoly grishin, nikolay chuzhikov, vyacheslav ionov, vladimir morozov	URS	Canoeing	1
anatoly mikhaylov	URS	Athletics	1
anatoly sass, aleksandr timoshinin	URS	Rowing	1
anca patrascoiu	ROM	Swimming	1
anders g?rderud	SWE	Athletics	1
anders holmertz	SWE	Swimming	3
anders holmertz, lars fr?lander, tommy werner, christer wallin	SWE	Swimming	1
andrea gyarmati	HUN	Swimming	2
andrea pollack	GDR	Swimming	3
andrea pollack, claudia hempel, kornelia ender, petra priemer	GDR	Swimming	1
andrea pollack, hannelore anke, kornelia ender, ulrike richter	GDR	Swimming	1
andreas dittmer	GER	Canoeing	4
andreas dittmer, gunar kirchbach	GER	Canoeing	1
andreas hajek, andr? steiner, stephan volkert, andr? willms	GER	Rowing	1
andreas ihle, martin hollstein	GER	Canoeing	1
andreas st?hle	GDR	Canoeing	1
andreas szigat, christian tr?ger, mark pinger, dirk richter, jonathon cleveland, steffen zesner, bengt zikarsky	GER	Swimming	1
andrei igorov	ROM	Canoeing	1
andre phillips	USA	Athletics	1
andrew byrnes, kyle hamilton, malcolm howard, adam kreek, ben rutledge, brian price, kevin light, jake wetzel, dominic sieterle	CAN	Rowing	1
andrew charlton	AUS	Swimming	4
andrew charlton, maurice christie, frank beaurepaire, ernest henry	AUS	Swimming	1
andrew jameson	GBR	Swimming	1
andrew lauterstein	AUS	Swimming	1
andrew lauterstein, patrick murphy, ashley callus, leith brodie, eamon sullivan, matt targett	AUS	Swimming	1
andrew triggs-hodge, steve williams, peter reed, tom james	GBR	Rowing	1
andrew trim, danny collins	AUS	Canoeing	1
andrey bogdanov, sergey koplyakov, andrey krylov, vladimir raskatov	URS	Swimming	1
andrey grechin, danila izotov, nikita lobintsev, vladimir morozov	RUS	Swimming	1
andrey korneyev	RUS	Swimming	1
andrey krylov	URS	Swimming	2
andrey perlov	URS	Athletics	1
andrey smirnov	URS	Swimming	1
andr? gaudin	FRA	Rowing	1
andrian dushev, milko kazanov	BUL	Canoeing	1
andriy serdinov	UKR	Swimming	1
andr?s hargitay	HUN	Swimming	1
andr? silva, arnaldo silva, edson ribeiro, robson da silva	BRA	Athletics	1
andr? wohllebe	GDR	Canoeing	1
andr? wohllebe, andreas st?hle, hans-j?rg bliesener, kay bluhm	GDR	Canoeing	1
andrzej badewski	POL	Athletics	1
andrzej gronowicz, jerzy opara	POL	Canoeing	1
andrzej zieliwski, wieslaw maniak, marian foik, marian dudziak	POL	Athletics	1
andy holmes, steven redgrave	GBR	Rowing	1
andy stanfield	USA	Athletics	2
aneta konieczna, beata mikolajczyk	POL	Canoeing	1
aneta pastuszka, beata sokolowska	POL	Canoeing	2
anette r?ckes, rita wilden, hildegard falck, inge b?dding	FRG	Athletics	1
anett schuck, manuela mucke, birgit fischer, katrin wagner	GER	Canoeing	1
angela alupei, constanta burcica-pipota	ROM	Rowing	1
angela bailey, france gareau, angella taylor, marita payne	CAN	Athletics	1
angela kennedy, helen denman, samantha riley, sarah ryan, nicole stevenson, susan o'neill	AUS	Swimming	1
angel martino	USA	Swimming	3
angelo taylor	USA	Athletics	2
angelo taylor, tony mcquay, bryshon nellum, joshua mance	USA	Athletics	1
anier garcia	CUB	Athletics	2
anita lonsbrough	GBR	Swimming	1
anita nall	USA	Swimming	2
anke m?hring	GDR	Swimming	1
anna olsson, susanne rosenqvist, maria haglund, agneta andersson	SWE	Canoeing	1
anna pfeffer	HUN	Canoeing	1
anna pfeffer, katalin rozsny?i	HUN	Canoeing	1
anna seaton, stephanie maxwell-pierson	USA	Rowing	1
ann curtis	USA	Swimming	2
annegret richter	FRG	Athletics	2
annelie ehrhardt	GDR	Athletics	1
annelies bredael	BEL	Rowing	1
anne marden	USA	Rowing	1
annemarie cox, annemiek derckx	NED	Canoeing	1
annemarie verstappen	NED	Swimming	2
annemiek de haan, hurnet dekkers, nienke hommes, esther worhel, froukje wegman, annemarieke van rumpt, marlies smulders, helen tanger, sarah siegelaar	NED	Rowing	1
annemiek derckx	NED	Canoeing	1
anne ottenbrite	CAN	Swimming	2
anne poleska	GER	Swimming	1
annie vernon, debbie flood, katherine grainger, frances houghton	GBR	Rowing	1
anni holdmann, leni junker, rosa kellner, leni schmidt	GER	Athletics	1
ann jardin, wendy hogg, robin corsiglia, susan sloan	CAN	Swimming	1
ann packer	GBR	Athletics	2
antal kiss	HUN	Athletics	1
antal r?ka	HUN	Athletics	1
antanas mikenas	URS	Athletics	1
anthony edwards, ben cureton, simon burgess, glen loftus	AUS	Rowing	1
anthony edwards, bruce hick	AUS	Rowing	1
anthony ervin	USA	Swimming	1
anthony mosse	NZL	Swimming	1
anthony nesty	SUR	Swimming	2
antje buschschulte	GER	Swimming	1
antje buschschulte, kerstin kielga?, sara harstick, franziska van almsick	GER	Swimming	1
antje buschschulte, meike freitag, simone osygus, sandra v?lker, franziska van almsick	GER	Swimming	1
antoaneta frenkeva	BUL	Swimming	2
antoine richard, hermann panzo, pascal barr?, patrick barr?	FRA	Athletics	1
antonel borsan, marcel glavan	ROM	Canoeing	1
antonina melnikova	URS	Canoeing	1
antonina seredina	URS	Canoeing	1
antonina seredina, lyudmila pinayeva-khvedosyuk	URS	Canoeing	1
antonina seredina, mariya shubina	URS	Canoeing	1
antonio leit?o	POR	Athletics	1
antonio mckay	USA	Athletics	1
antonio pettigrew, alvin harrison, calvin harrison, michael johnson	USA	Athletics	1
antonio rossi	ITA	Canoeing	1
antonio rossi, beniamino bonomi	ITA	Canoeing	2
antonio rossi, bruno dreossi	ITA	Canoeing	1
antonio scaduto, andrea facchin	ITA	Canoeing	1
antti kasvio	FIN	Swimming	1
archibald mckinnon, lorne loomer, donald arnold, ignace d'hondt	CAN	Rowing	1
archie hahn	USA	Athletics	3
archie williams	USA	Athletics	1
ardalion ignatyev	URS	Athletics	1
aries merritt	USA	Athletics	1
arkady vyatchanin	RUS	Swimming	2
armas toivonen	FIN	Athletics	1
armin hary	GER	Athletics	1
arne bergodd, rolf andreassen, ole nafstad, finn tveter	NOR	Rowing	1
arne borg	SWE	Swimming	4
arne borg, ?ke borg, georg werner, orvar trolle	SWE	Swimming	1
arne nielsson, christian wig?	DEN	Canoeing	1
arno bieberstein	DEU	Swimming	1
arnold jackson	GBR	Athletics	1
arnold jonke, christoph zerbst	AUT	Rowing	1
arsen miskarov	URS	Swimming	2
arthur ayrault, john sayre, ted nash, rusty wailes	USA	Rowing	1
arthur barnard	USA	Athletics	1
arthur blake	USA	Athletics	1
arthur jonath	GER	Athletics	1
arthur newton	USA	Athletics	2
arthur porritt	NZL	Athletics	1
arthur schwab	SUI	Athletics	1
arthur shaw	USA	Athletics	1
arthur wint	JAM	Athletics	3
arto bryggare	FIN	Athletics	1
artur svensson, gustav weijnarth, nils engdahl, erik byl?hn	SWE	Athletics	1
artur wojdat	POL	Swimming	1
arvidas juozaitis	URS	Swimming	1
arvo aaltonen	FIN	Swimming	1
arvo askola	FIN	Athletics	1
arvo ojanper?	FIN	Canoeing	1
asafa powell, michael frater, nesta carter, usain bolt, dwight thomas	JAM	Athletics	1
asbel kiprop	KEN	Athletics	1
ashley tappin, jenny thompson, angel martino, nicole haislett, crissy ahmann-leighton, dara torres	USA	Swimming	1
asli cakir alptekin	TUR	Athletics	1
assefa mezgebu	ETH	Athletics	1
astrid strau?	GDR	Swimming	1
atanase sciotnic, aurel vernescu, mihai turcas, simion cuciuc	ROM	Canoeing	1
athanasia tsoumeleka	GRE	Athletics	1
ato boldon	TRI	Athletics	4
attila adrovicz, ferenc csipes, andr?s rajna, g?bor horv?th	HUN	Canoeing	1
attila ?brah?m, ferenc csipes	HUN	Canoeing	1
attila ?brah?m, ferenc csipes, zsolt gyulai, l?szl? fidel	HUN	Canoeing	1
attila czene	HUN	Swimming	2
attila vajda	HUN	Canoeing	2
audrey patterson	USA	Athletics	1
audrey williamson	GBR	Athletics	1
audun boysen	NOR	Athletics	1
august desch	USA	Athletics	1
aurel vernescu	ROM	Canoeing	1
aurica barascu, georgeta damian, doina ignat, elena georgescu, rodica florea, liliana gafencu, viorica susanu, ioana papuc, elisabeta lipa	ROM	Rowing	1
aya terakawa	JPN	Swimming	1
aya terakawa, yuka kato, haruka ueda, satomi suzuki	JPN	Swimming	1
barbara burke, audrey brown, eileen hiscock, violet olney	GBR	Athletics	1
barbara ferrell	USA	Athletics	1
barbara g?bel	GER	Swimming	1
barbara jones, martha hudson, wilma rudolph, lucinda williams	USA	Athletics	1
barbara krause	GDR	Swimming	2
barbara olmsted, lucie guay, sue holloway, alexandra barr?	CAN	Canoeing	1
barbara sch?ttpelz	FRG	Canoeing	1
barney ewell	USA	Athletics	2
barry kelly, grant kenny	AUS	Canoeing	1
barry magee	NZL	Athletics	1
basil heatley	GBR	Athletics	1
beata mikolajczyk, karolina naja	POL	Canoeing	1
beatrice caslaru	ROM	Swimming	2
beatrice lyons	AUS	Swimming	1
beatrice utondu, mary onyali, christy opara-thompson, faith idehen	NGR	Athletics	1
beaufort burdekin, robert bourne, william fison, thomas gillespie, john walker, arthur wiggins, charles littlejohn, william parker, frederick pitman	GBR	Rowing	1
becky smith	CAN	Swimming	1
becky smith, gail amundrud, barbara clark, ann jardin	CAN	Swimming	1
ben eastman	USA	Athletics	1
ben fouhy	NZL	Canoeing	1
bengt baron	SWE	Swimming	1
ben hunt-davis, simon dennis, rowley douglas, louis attrill, steve trapmore, kieran west, andrew lindsay, luka grubor, fred scarlett	GBR	Rowing	1
beniamino bonomi	ITA	Canoeing	1
beniamino bonomi, daniele scarpa	ITA	Canoeing	1
benita fitzgerald-brown	USA	Athletics	1
benjamin kogo	KEN	Athletics	1
ben jipcho	KEN	Athletics	1
ben johnson	CAN	Athletics	1
ben johnson, tony sharpe, sterling hinds, desai williams	CAN	Athletics	1
benny nielsen	DEN	Swimming	1
bent rasch, finn haunstoft	DEN	Canoeing	1
bergen, csima, gibson, mccabe, howard, byrnes, brown, crothers, price	CAN	Rowing	1
bernard bregeon	FRA	Canoeing	1
bernard lagat	KEN	Athletics	2
bernardo sugura	MEX	Athletics	1
bernard williams iii	USA	Athletics	1
bernd duvigneau, r?diger helm, frank-peter bischof, j?rgen lehnert	GDR	Canoeing	1
bernd kannenberg	FRG	Athletics	1
bernd landvoigt, j?rg landvoigt	GDR	Rowing	2
bernd landvoigt, j?rg landvoigt, hans-joachim borzym, harold dimke, heinrich mederow, dietmar schwarz, manfred schmorde, manfred schneider, hartmut schreiber	GDR	Rowing	1
bernd olbricht, joachim mattern	GDR	Canoeing	1
bernhard von gaza	DEU	Rowing	1
bershawn jackson	USA	Athletics	1
bertha brouwer	NED	Athletics	1
bertil albertsson	SWE	Athletics	1
bertrand vecten, olivier moncelet, gilles bosquet, daniel fauche	FRA	Rowing	1
beth botsford	USA	Swimming	1
betsy mitchell	USA	Swimming	1
betty cuthbert	AUS	Athletics	3
beverley whitfield	AUS	Swimming	2
beverly mcdonald	JAM	Athletics	1
bevil rudd	SAF	Athletics	2
bill carr	USA	Athletics	1
bill dellinger	USA	Athletics	1
bill hogenson	USA	Athletics	2
bill mulliken	USA	Swimming	1
billy mills	USA	Athletics	1
birgit fischer	GDR	Canoeing	2
birgit fischer	GER	Canoeing	1
birgit fischer, anke nothnagel-von seck	GDR	Canoeing	1
birgit fischer, carolin leonhardt	GER	Canoeing	1
birgit fischer, katrin wagner	GER	Canoeing	1
birgit fischer, ramona portwich	GER	Canoeing	1
birgit fischer, ramona portwich, anett schuck, manuela mucke	GER	Canoeing	1
birgit fischer, ramona portwich, heike singer, anke nothnagel-von seck	GDR	Canoeing	1
birgit peter, martina schr?ter	GDR	Rowing	1
birgit treiber	GDR	Swimming	3
birte weigang	GDR	Swimming	2
birte weigang, kathrin mei?ner, kristin otto, silke h?rner	GDR	Swimming	1
birute sakickiene, kristina poplavskaja	LTU	Rowing	1
bisi afolabi, falilat ogunkoya, charity opara, fatima yusuf	NGR	Athletics	1
bjorn bach, jan sch?fer, stefan ulm, mark zabel	GER	Canoeing	1
bj?rn hasl?v, kurt helmudt, john hansen, erik petersen	DEN	Rowing	1
b?la goldov?nyi, gy?rgy cs?nyi, l?szl? zar?ndi, g?za varasdi	HUN	Athletics	1
blain lindgren	USA	Athletics	1
blair horn, mark evans, michael evans, dean crawford, grant main, kevin neufeld, brian mcmahon, paul steele, patrick turner	CAN	Rowing	1
bobby morrow	USA	Athletics	2
bobby pearce	AUS	Rowing	2
bob hayes	USA	Athletics	1
bob leavitt	USA	Athletics	1
bob schul	USA	Athletics	1
bob sohl	USA	Swimming	1
bob tisdall	IRL	Athletics	1
bodo t?mmler	FRG	Athletics	1
bo gustafsson	SWE	Athletics	1
bohuslav karl?k	CZE	Canoeing	1
bong-ju lee	KOR	Athletics	1
bonnie mealing	AUS	Swimming	1
borislav ananiev, nikolay ilkov	BUL	Canoeing	1
borislav borisov, lazar khristov, bozhidar milenkov, ivan manev	BUL	Canoeing	1
boris steimetz, fabien gilot, alain bernard, fr?d?rick bousquet, amaury leveaux, gregory mallet	FRA	Swimming	1
botond storcz, g?bor horv?th, zoltan kammerer, akos vereckei	HUN	Canoeing	1
bouguerra el quafi	FRA	Athletics	1
bowen stassforth	USA	Swimming	1
brad bridgewater	USA	Swimming	1
bradford cooper	AUS	Swimming	1
bradley lewis, paul enquist	USA	Rowing	1
brahim boutayeb	MAR	Athletics	1
brahim lahlafi	MAR	Athletics	1
b?rbel w?ckel-eckert	GDR	Athletics	2
b?rbel w?ckel-eckert, renate stecher, carla bodendorf, marlies g?hr-oelsner	GDR	Athletics	1
brenda helser, thelma kalama, marie corridon, ann curtis	USA	Swimming	1
brenda jones	AUS	Athletics	1
brendan foster	GBR	Athletics	1
brendan hansen	USA	Swimming	3
brendan hansen, michael phelps, nathan adrian, matthew grevers	USA	Swimming	1
brent hayden	CAN	Swimming	1
brenton rickard	AUS	Swimming	1
brian diemer	USA	Athletics	1
brian goodell	USA	Swimming	2
brian job	USA	Swimming	1
brian peaker, dave boyes, gavin hassett, jeffrey lay	CAN	Rowing	1
bridgitte hartley	RSA	Canoeing	1
brigita bukovec	SLO	Athletics	1
brimin kiprop	KEN	Athletics	1
brimin kipruto	KEN	Athletics	1
britta oppelt, annekatrin thiele, carina baer, julia richter	GER	Rowing	1
britta oppelt, peggy waleska	GER	Rowing	1
britta steffen	GER	Swimming	2
britta steffen, meike freitag	GER	Swimming	1
bronislaw malinowski	POL	Athletics	2
bronte barratt	AUS	Swimming	1
bronte barratt, alicia coutts, kylie palmer, melanie schlanger	AUS	Swimming	1
brooke bennett	USA	Swimming	3
brooke hanson	AUS	Swimming	1
bruce furniss	USA	Swimming	1
bruce robertson	CAN	Swimming	1
bruno boni, felice fanetti	ITA	Rowing	1
bruno junk	URS	Athletics	1
bruno mascarenhas, lorenzo bertini, catello amarante, salvatore amitrano	ITA	Rowing	1
bud spencer, frederick alderman, george baird, raymond barbuti	USA	Athletics	1
buffy alexander, laryssa biesenthal, heather davis, alison korn, theresa luke, emma robinson, heather mcdermid, dorota urbaniak, lesley thompson	CAN	Rowing	1
buster crabbe	USA	Swimming	2
butch reynolds	USA	Athletics	1
cafaro, francia, lofgren, ritzel, musnicki, logan, lind, davies, whipple	USA	Rowing	1
caitlin leverenz	USA	Swimming	1
calvin davis	USA	Athletics	1
calvin smith	USA	Athletics	1
camelia potec	ROM	Swimming	1
cameron henning	CAN	Swimming	1
cameron van der burgh	RSA	Swimming	1
camille muffat	FRA	Swimming	2
caren metschuck	GDR	Swimming	2
caren metschuck, andrea pollack, ute geweniger, rica reinisch	GDR	Swimming	1
carina ljungdahl, agneta eriksson, tina gustafsson, agneta m?tensson	SWE	Swimming	1
carin cone	USA	Swimming	1
carin ter beek, pieta van dishoeck, eeke van nes, anneke venema, marieke westerhof, nelleke penninx, elien meijer, martijntje quik, tessa appeldoorn	NED	Rowing	1
carl kaufmann	GER	Athletics	1
carl lewis	USA	Athletics	4
carlo monti, michele tito, enrico perucconi, antonio siddi	ITA	Athletics	1
carlos mercenario	MEX	Athletics	1
carlos perez, saul craviotto	ESP	Canoeing	1
carlos sousa lopes	POR	Athletics	2
carl robie	USA	Swimming	2
carmela schmidt	GDR	Swimming	2
carmelita jeter	USA	Athletics	2
carola zirzow	GDR	Canoeing	1
carola zirzow, b?rbel k?ster	GDR	Canoeing	1
carolina evers-swindell, georgina evers-swindell	NZL	Rowing	2
caroline brunet	CAN	Canoeing	3
carolin martina leonhardt, katrin wagner-augustin, tina dietze, franziska weber	GER	Canoeing	1
carolyn schuler	USA	Swimming	1
carolyn schuler, chris von saltza, lynn burke, patty kempner	USA	Swimming	1
carrie steinseifer	USA	Swimming	1
carrie steinseifer, dara torres, nancy hogshead, jenna johnson	USA	Swimming	1
carsta gen?u?, martina bischof	GDR	Canoeing	1
caster semenya	RSA	Athletics	1
cate campbell	AUS	Swimming	1
cate campbell, alice mills, shayne reese, melanie schlanger, lisbeth trickett	AUS	Swimming	1
cate campbell, alicia coutts, melanie schlanger, brittany elmslie	AUS	Swimming	1
cath bishop, katherine grainger	GBR	Rowing	1
catherine carr	USA	Swimming	1
catherine fox, lisa jacob, angel martino, jenny thompson, melanie valerio, amy van dyken	USA	Swimming	1
catherine gibson	GBR	Swimming	1
catherine ndereba	KEN	Athletics	2
catherine plewinski	FRA	Swimming	2
catherine poirot	FRA	Swimming	1
cathleen rund	GER	Swimming	1
cathy ferguson	USA	Swimming	1
cathy freeman	AUS	Athletics	2
cecil healy	ANZ	Swimming	1
cecil healy	AUS	Swimming	1
cecil healy, leslie boardman, malcolm champion, harold hardwick	ANZ	Swimming	1
cerstin petersmann, dana pyritz, daniela neunast, judith zeidler, ute wagner-stange, annegret strauch, kathrin haacker, christiane harzendorf, sylvia d?rdelmann	GER	Rowing	1
cesar cielofilho	BRA	Swimming	2
cesar cielo filho	BRA	Swimming	1
cesare milani, enrico garzelli, guglielmo del bimbo, renato bracci, mario balleri, renato barbieri, dino barsotti, vittorio cioni, roberto vestrini	KIT	Rowing	1
chad le clos	RSA	Swimming	2
chandra cheeseborough	USA	Athletics	1
chandra cheeseborough, jeanette bolden, alice brown, evelyn ashford	USA	Athletics	1
chandra sturrup, sevatheda fynes, pauline davis-thompson, eldece clark	BAH	Athletics	1
charilaos vasilakos	GRE	Athletics	1
charles asati, hezekiah nyamau, robert ouko, julius sang	KEN	Athletics	1
charles bacon	USA	Athletics	1
charles bennett	GBR	Athletics	1
charles borah, jimmy quinn, frank wykoff, hank russell	USA	Athletics	1
charles burnell, raymond etherington-smith, henry bucknall, albert gladstone, gilchrist maclagen, banner johnstone, frederick kelly, guy nickalls, ronald sanderson	GBR	Rowing	1
charles chandler, james blair, david dunlap, norris graham, duncan gregg, winslow hall, harold tower, edwin salisbury, burton jastram	USA	Rowing	1
charles daniels	USA	Swimming	2
charles day, gordon adam, donald hume, george hunt, james mcmillin, bob moch, herbert morris, joseph rantz, john white	USA	Rowing	1
charles gmelin	GBR	Athletics	1
charles hefferon	SAF	Athletics	1
charles hickcox	USA	Swimming	3
charles hickcox, donald mckenzie, kenneth walsh, douglas russell	USA	Swimming	1
charles jenkins	USA	Athletics	1
charles lelong, pierre failliot, robert schurrer, charles poulenard	FRA	Athletics	1
charles moore	USA	Athletics	1
charles paddock	USA	Athletics	3
charles reidpath	USA	Athletics	1
charles spedding	GBR	Athletics	1
charlie greene	USA	Athletics	1
charlotte radcliffe, hilda james, constance jeans, grace mckenzie	GBR	Swimming	1
charmaine crooks, molly killingbeck, marita payne, jillian richardson	CAN	Athletics	1
cheryl gibson	CAN	Swimming	1
chester jastremski	USA	Swimming	1
chris brasher	GBR	Athletics	1
chris jacobs	USA	Swimming	1
chris jacobs, matt biondi, david berkoff, richard schroeder	USA	Swimming	1
chris mahoney, duncan mcdougall, malcolm mcgowan, colin moynihan, john pritchard, richard stanhope, john clay, andrew justice, allan whitwell	GBR	Rowing	1
christa stubnick	GER	Athletics	2
chris thompson	USA	Swimming	1
christiane huth, annekatrin thiele	GER	Rowing	1
christiane knacke	GDR	Swimming	1
christiane pielke, iris zscherpe, susanne schuster, karin seick	FRG	Swimming	1
christiane wartenberg	GDR	Athletics	1
christian gille, tomasz wylenzek	GER	Canoeing	3
christian gitsham	SAF	Athletics	1
christian ryan, nick porzig, mike mckay, stuart welch, robert jahrling, brett hayman, alastair gordon, daniel burke, jaime fernandez	AUS	Rowing	1
christian sprenger	AUS	Swimming	1
christian sprenger, hayden stoeckel, matt targett, james magnussen	AUS	Swimming	1
christina lathan-brehmer	GDR	Athletics	2
christina lathan-brehmer, barbara krug, marita koch, gabriele l?we	GDR	Athletics	1
christina lathan-brehmer, doris maletzki, brigitte rohde, ellen streidt	GDR	Athletics	1
christine collins, sarah garner	USA	Rowing	1
christine gosse, h?l?ne cortin	FRA	Rowing	1
christine magnuson	USA	Swimming	1
christine ohuruogu	GBR	Athletics	2
christine wachtel	GDR	Athletics	1
christoph h?hne	GDR	Athletics	1
chris von saltza	USA	Swimming	2
chris von saltza, shirley stobs, joan spillane, carolyn wood	USA	Swimming	1
chris williams, danny mcfarlane, michael blackwood, greg haughton	JAM	Athletics	1
claire dennis	AUS	Swimming	1
clarence demar	USA	Athletics	1
clarke scholes	USA	Swimming	1
claude piquemal, g?rard f?nouil, jocelyn delecour, roger bambuck	FRA	Athletics	1
claudia blasberg, daniela reimer	GER	Rowing	1
claudia blasberg, valerie viehoff	GER	Rowing	1
claudia kolb	USA	Swimming	3
claudia poll	CRC	Swimming	3
claudia zaczkiewicz	FRG	Athletics	1
clement chukwu, sunday bada, jude monye, enefiok udo-obong	NGR	Athletics	1
cliff cushman	USA	Athletics	1
clinton hill, patrick dwyer, mark ormrod, john steffensen	AUS	Athletics	1
clint robinson	AUS	Canoeing	2
clint robinson, nathan baggaley	AUS	Canoeing	1
clyde hefer, stephen evans, james battersby, ian edmunds, craig muller, sam patten, ion popa, gavin thredgold, timothy willoughby	AUS	Rowing	1
clyde scott	USA	Athletics	1
colette besson	FRA	Athletics	1
colin jackson	GBR	Athletics	1
colin smith, tom stallard, josh west, matthew langridge, tom lucy, alex partridge, alastair heathcote, richard egington	GBR	Rowing	1
colin von ettingshausen, peter h?ltzenbein	GER	Rowing	1
colleen lanne, kara lynn joyce, maritza correia, lindsay benko, natalie coughlin, amanda weir, jenny thompson	USA	Swimming	1
con cochran, alan helffrich, oliver macdonald, bill stevenson	USA	Athletics	1
conny van bentum, desi reijers, annemarie verstappen, elles voskes	NED	Swimming	1
conny van bentum, marianne muis, mildred muis, karin brienese	NED	Swimming	1
conny van bentum, wilma van velsen, reggie de jong, annelies maas	NED	Swimming	1
conny wassmuth, katrin wagner, fanny fischer, nicole reinhardt	GER	Canoeing	1
conrad robertson, shane o'brien, les o'connell, keith trask	NZL	Rowing	1
constance titus	USA	Rowing	1
constanta burcica-pipota, angela alupei	ROM	Rowing	1
constanta burcica-pipota, camelia macoviciuc	ROM	Rowing	1
constantina tomescu	ROM	Athletics	1
cornelia polit	GDR	Swimming	1
cornelia sideri, hilde lauer	ROM	Canoeing	1
cornelia sirch	GDR	Swimming	2
costica olaru	ROM	Canoeing	1
courtney shealy, ashley tappin, dara torres, erin phenix, amy van dyken, jenny thompson	USA	Swimming	1
craig dixon	USA	Athletics	1
crissy ahmann-leighton	USA	Swimming	1
cristiena cojocaru	ROM	Athletics	1
cristina teuscher	USA	Swimming	1
csaba giczi, istv?n tim?r	HUN	Canoeing	1
csaba horv?th, gy?rgy kolonics	HUN	Canoeing	2
cullen jones	USA	Swimming	1
curtis myden	CAN	Swimming	3
cyril gill, jack london, edward smouha, walter rangeley	GBR	Athletics	1
cyril stiles, fred thompson	NZL	Rowing	1
dagmar hase	GER	Swimming	5
daichi suzuki	JPN	Swimming	1
dana schoenfield	USA	Swimming	1
dana vollmer	USA	Swimming	1
dana vollmer, allison schmitt, missy franklin, shannon vreeland	USA	Swimming	1
dana vollmer, allison schmitt, rebecca soni, missy franklin	USA	Swimming	1
dana vollmer, rhi jeffrey, lindsay benko, natalie coughlin, carly piper, kaitlin sandeno, rachel komisarz	USA	Swimming	1
daniela hunger	GDR	Swimming	2
daniela hunger	GER	Swimming	1
daniela hunger, kathrin mei?ner, kristin otto, manuela stellmach	GDR	Swimming	1
daniela neunast, ute wild, ute wagner-stange, beatrix schr?er, annegret strauch, ramona balthasar, anja kluge, kathrin haacker, judith zeidler	GDR	Rowing	1
daniela walkowiak?wna	POL	Canoeing	1
daniel barrow	USA	Rowing	1
daniel bautista	MEX	Athletics	1
daniele scarpa, antonio rossi	ITA	Canoeing	1
daniel gyurta	HUN	Swimming	2
daniel harrigan	USA	Swimming	1
daniel jedraszko, pawel baraszkiewicz	POL	Canoeing	1
daniel kowalski	AUS	Swimming	3
daniel plaza	ESP	Athletics	1
daniel sangouma, gilles qu?n?herv?, max morini?re, bruno marie-rose	FRA	Athletics	1
dan kinsey	USA	Athletics	1
danny collins, andrew trim	AUS	Canoeing	1
danny everett	USA	Athletics	1
danny harris	USA	Athletics	1
danny mcfarlane	JAM	Athletics	1
danuta kozak	HUN	Canoeing	1
danut dobre, marin gheorghe, vasile lonel mastacan, claudiu gabriel marin, vasile dorel nastase, loan lulian vizitiu, iulica ruican, viorel talapan, valentin robu	ROM	Rowing	1
danyon loader	NZL	Swimming	3
daphne hasenjager	SAF	Athletics	1
dara torres	USA	Swimming	4
darcy hadfield	NZL	Rowing	1
dario dentale, luca agamennoni, lorenzo porzio, raffaello leonardo	ITA	Rowing	1
darren campbell	GBR	Athletics	1
dave hall	USA	Athletics	1
dave wottle	USA	Athletics	1
davian clarke, greg haughton, michael mcdonald, roxbert martin	JAM	Athletics	1
david berkoff	USA	Swimming	2
david cal	ESP	Canoeing	5
david collins, william carlucci, jeff pfaendtner, marc schneider	USA	Rowing	1
david crawshay, scott brennan	AUS	Rowing	1
david davies	GBR	Swimming	1
davide rummolo	ITA	Swimming	1
david fox, scott tucker, jon olsen, brad schumacher, josh davis, gary hall jr.	USA	Swimming	1
david gillanders	USA	Swimming	1
david grindley, kriss akabusi, roger black, john regis	GBR	Athletics	1
david hemery	GBR	Athletics	2
david jacobs, henry macintosh, vic d'arcy, willie applegarth	GBR	Athletics	1
david kopriva, jakub hanak, david jirka, tomas karas	CZR	Rowing	1
david larsen, bruce hayes, mike heath, jeffrey float, geoffrey gaberino	USA	Swimming	1
david lekuta rudisha	KEN	Athletics	1
david lowe, duncan goodhew, gary abraham, trevor smith	GBR	Swimming	1
david l?pez-zubero	ESP	Swimming	1
david neville	USA	Athletics	1
david oliver	USA	Athletics	1
david payne	USA	Athletics	1
david power	AUS	Athletics	1
david segal, peter radford, neville whitehead, david jones	GBR	Athletics	1
david sime	USA	Athletics	1
david theile	AUS	Swimming	2
david townsend, ian mcnuff, martin cross, john beattie	GBR	Rowing	1
david wharton	USA	Swimming	1
david wilkie	GBR	Swimming	3
david wilson	USA	Swimming	1
davis kamoga	UGA	Athletics	1
dawn fraser	AUS	Swimming	4
dawn harper	USA	Athletics	2
dayron robles	CUB	Athletics	1
debbie ferguson	BAH	Athletics	1
debbie flintoff-king	AUS	Athletics	1
debbie flood, frances houghton, alison mowbray, rebecca romero	GBR	Rowing	1
debbie meyer	USA	Swimming	3
debra sapenter, rosalyn bryant, pamela jiles, sheila ingram	USA	Athletics	1
deedee trotter	USA	Athletics	1
deena kastor	USA	Athletics	1
dejen gebremeskel	ETH	Athletics	1
delfo cabrera	ARG	Athletics	1
demitrios golemis	GRE	Athletics	1
denis alexeev, vladislav frolov, maksim dyldin, anton kokorin	RUS	Athletics	1
denis nizhegorodov	RUS	Athletics	2
denis pankratov	RUS	Swimming	2
denis pimankov, roman yegorov, vladimir predkin, vladimir pyshnenko, aleksandr popov	RUS	Swimming	1
dennis mitchell	USA	Athletics	1
dennis mitchell, mike marsh, carl lewis, leroy burrell	USA	Athletics	1
denys sylant'yev	UKR	Swimming	1
deon hemmings	JAM	Athletics	2
deon hemmings, lorraine graham, sandie richards, catherine scott-pomales	JAM	Athletics	1
derartu tulu	ETH	Athletics	3
derek ibbotson	GBR	Athletics	1
derek johnson	GBR	Athletics	1
derek porter	CAN	Rowing	1
derrick adkins	USA	Athletics	1
derrick brew	USA	Athletics	1
derrick brew, otis harris jr, darold williamson, jeremy wariner	USA	Athletics	1
detlef lewe	FRG	Canoeing	2
diana mocanu	ROM	Swimming	2
diana munz	USA	Swimming	2
diana munz, julia stowers, lindsay benko, kim black, samantha arsenault, jenny thompson	USA	Swimming	1
diana paliyska, vanja gesheva-tsvetkova	BUL	Canoeing	1
dick quax	NZL	Athletics	1
didier hoyer, eric renaud	FRA	Canoeing	1
didier hoyer, olivier boivin	FRA	Canoeing	1
diederik simon, niels van der zwan, nico rienks, koos maasdijk, jeroen duyster, ronald florijn, michiel bartman, henk-jan zwolle, niels van steenis	NED	Rowing	1
dieter baumann	FRG	Athletics	1
dieter baumann	GER	Athletics	1
dieter grahn, frank forberger, dieter schubert, frank r?hle	GDR	Rowing	1
dieter lindner	GER	Athletics	1
dieter wendisch, karl-heinz prud?hl, roland kostulski, hans-joachim l?ck, gottfried d?hn, werner klatt, ulrich karnatz, karl-heinz danielowski, bernd baumgart	GDR	Rowing	1
dimitrie ivanov, haralambie ivanov, anton calenic, mihai turcas	ROM	Canoeing	1
ding chen	CHN	Athletics	1
dirk crois, pierre-marie deloof	BEL	Rowing	1
dirk lippits, michiel bartman, diederik simon, jochem verberne	NED	Rowing	1
dirk richter, steffen zesner, thomas flemming, lars hinneburg	GDR	Swimming	1
disqualified, usa	NA	Athletics	1
djan madruga, jorge fernandes, ciro marques delgado, marcus mattioli	BRA	Swimming	1
djurdica bjedov	YUG	Swimming	2
dmitry volkov	URS	Swimming	1
dmitry volkov, vadim yaroshchuk, gennady prigoda, igor polyansky	URS	Swimming	1
doina ignat, constanta burcica-pipota, georgeta andrunache, eniko barab?s, viorica susanu, rodica serban, simona musat, ioana papuc	ROM	Rowing	1
doina ignat, georgeta damian	ROM	Rowing	1
doina ignat, liliana gafencu, elena georgescu, georgeta damian, vera cochelea, maria magdalena dumitrache, elisabeta lipa, ioana olteanu, viorica susanu	ROM	Rowing	1
doina ignat, vera cochelea, anisoara dobre-balan, constanta burcica-pipota	ROM	Rowing	1
doina melinte	ROM	Athletics	2
domenico fioravanti	ITA	Swimming	2
donald boal, earl eastwood, harry fry, joseph harris, cedric liddell, george macdonald, albert taylor, william thoburn, stanley stanyar	CAN	Rowing	1
donald finlay	GBR	Athletics	2
donald lippincott	USA	Athletics	2
donald mckenzie	USA	Swimming	1
donald smith, gary macdonald, stephen pickell, clay evans	CAN	Swimming	1
dongxiang xu, wenyi huang	CHN	Rowing	1
donna de varona	USA	Swimming	1
donna de varona, kathleen ellis, sharon stouder, pokey watson	USA	Swimming	1
donna gurr	CAN	Swimming	1
donovan bailey	CAN	Athletics	1
don quarrie	JAM	Athletics	3
don schollander	USA	Swimming	3
don thompson	GBR	Athletics	1
dorian mortelette, benjamin rondeau, germain chardin, julien despr?s	FRA	Rowing	1
dorothy hyman	GBR	Athletics	2
dorothy manley	GBR	Athletics	1
douglas bennett	CAN	Canoeing	1
douglas gjertsen, troy dalbey, matt cetlinski, matt biondi	USA	Swimming	1
douglas lowe	GBR	Athletics	2
douglas northway	USA	Swimming	1
douglas russell	USA	Swimming	1
douglas wakiihuri	KEN	Athletics	1
dragos neagu, danut dobre	ROM	Rowing	1
drew ginn, duncan free	AUS	Rowing	1
drew ginn, james chapman, joshua dunkley-smith, william lockwood	AUS	Rowing	1
drew ginn, nicholas green, mike mckay, james tomkins	AUS	Rowing	1
dudley storey, dick tonks, noel mills, ross collinge	NZL	Rowing	1
duje draganja	CRO	Swimming	1
duke kahanamoku	USA	Swimming	3
duncan armstrong	AUS	Swimming	2
duncan free, janusz hooker, bo hanson, ron snook	AUS	Rowing	1
duncan goodhew	GBR	Swimming	1
duncan white	SRI	Athletics	1
dwayne evans	USA	Athletics	1
eamon sullivan	AUS	Swimming	1
earl eby	USA	Athletics	1
earl jones	USA	Athletics	1
earl thomson	CAN	Athletics	1
eckhard leue	GDR	Canoeing	1
ed coode, james cracknell, steve williams, matthew pinsent	GBR	Rowing	1
eddie hart, larry black, robert taylor, gerald tinker	USA	Athletics	1
eddie southern	USA	Athletics	1
eddie tolan	USA	Athletics	2
eddy ottoz	ITA	Athletics	1
edith mcguire	USA	Athletics	2
ed mckeever	GBR	Canoeing	1
ed moses	USA	Swimming	1
eduardo guerrero, tranquilo cappozzo	ARG	Rowing	1
eduardo risso	URU	Rowing	1
edvin wide	SWE	Athletics	4
edward lindberg	USA	Athletics	1
edwin moses	USA	Athletics	3
edwin roberts	TRI	Athletics	1
edwin soi	KEN	Athletics	1
eeke van nes, pieta van dishoeck	NED	Rowing	1
eero berg	FIN	Athletics	1
egil s?by, jan johansen, steinar amundsen, tore berger	NOR	Canoeing	1
egil s?by, steinar amundsen, tore berger, jan johansen	NOR	Canoeing	1
egon drews, wilfried soltau	GER	Canoeing	1
eino purje-borg	FIN	Athletics	1
eirik larsen	NOR	Canoeing	2
eirik veraas larsen	NOR	Canoeing	1
ejigayehu dibaba	ETH	Athletics	1
ekaterina karsten	BLR	Rowing	1
ekaterina poistogova	RUS	Athletics	1
ekaterini thanou	GRE	Athletics	1
elaine tanner	CAN	Swimming	2
elaine tanner, marion lay, marilyn corson, angela coughlan	CAN	Swimming	1
elana meyer	RSA	Athletics	1
eleanor garatti-saville	USA	Swimming	2
eleanor holm	USA	Swimming	1
elena lashmanova	RUS	Athletics	1
elfi zinn	GDR	Athletics	1
elia luini, leonardo pettinari	ITA	Rowing	1
elias katz	FIN	Athletics	1
elio ragni, orazio mariani, tullio gonnelli, gianni caldana	KIT	Athletics	1
elisabeta lipa	ROM	Rowing	1
elisabeta lipa, vera cochelea	ROM	Rowing	1
elisabeta lipa, vera cochelea, anisoara dobre-balan	ROM	Rowing	1
elisa rigaudo	ITA	Athletics	1
elise laverick, anna bebington	GBR	Rowing	1
eliud kipchoge	KEN	Athletics	2
elizabeth beisel	USA	Swimming	2
elizabeth davies	GBR	Swimming	1
elizabeth mccolgan	GBR	Athletics	1
elizabeth robinson	USA	Athletics	1
elizabeth wagstaff, nicole haislett, megan kleine, crissy ahmann-leighton, jenny thompson, summer sanders, anita nall, lea loveless	USA	Swimming	1
elke sehmisch, gabriele wetzko, kornelia ender, andrea eife	GDR	Swimming	1
ellen fiedler	GDR	Athletics	1
ellen king	GBR	Swimming	1
ellen king, joyce cooper, cissie stewart, vera tanner	GBR	Swimming	1
ellen streidt	GDR	Athletics	1
ellen van langen	NED	Athletics	1
ellie daniel	USA	Swimming	3
ellie daniel, catie ball, kaye hall, susan pedersen	USA	Swimming	1
elliott bunney, linford christie, mike mcfarlane, john regis	GBR	Athletics	1
elodie ouedraogo, hanna marien, olivia borlee, kim gevaert	BEL	Athletics	1
else jacobsen	DEN	Swimming	1
elvan abeylegesse	TUR	Athletics	2
elvira vasilkova	URS	Swimming	1
emanuele merisi	ITA	Swimming	1
emanuel silva, fernando piment	POR	Canoeing	1
emiel puttemans	BEL	Athletics	1
emil breitkreutz	USA	Athletics	1
emile champion	FRA	Athletics	1
emilio lunghi	KIT	Athletics	1
emily seebohm	AUS	Swimming	1
emily silver, julia smit, dara torres, kara lynn joyce, lacey nymeyer, natalie coughlin	USA	Swimming	1
emil z?topek	CZE	Athletics	5
emmanuel bailey	GBR	Athletics	1
enith brigitha	NED	Swimming	2
enrique figuerola	CUB	Athletics	1
enrique figuerola, hermes ramirez, pablo montes, juan morales	CUB	Athletics	1
eric fish, robert kasting, william mahony, bruce robertson	CAN	Swimming	1
erich borchmeyer, erwin gillmeister, wilhelm leichum, gerd hornberger	GER	Athletics	1
erich borchmeyer, helmuth k?rnig, arthur jonath, fritz hendrix	GER	Athletics	1
erich koschik	GER	Canoeing	1
erich rademacher	GER	Swimming	1
erick barrondo	GUA	Athletics	1
erick wainaina	KEN	Athletics	2
eric liddell	GBR	Athletics	2
eric murray, hamish bond	NZL	Rowing	1
eric namesnik	USA	Swimming	2
eric verdonk	NZL	Rowing	1
erik backman	SWE	Athletics	1
erik byl?hn	SWE	Athletics	1
erik christiansen, lars nielsen, per rasmussen, michael jessen	DEN	Rowing	1
erik elms?ter	SWE	Athletics	1
erik hansen	DEN	Canoeing	2
erik vendt	USA	Swimming	2
erkka wil?n	FIN	Athletics	1
erminio dones, pietro annoni	KIT	Rowing	1
ernesto ambrosini	KIT	Athletics	1
ernesto canto	MEX	Athletics	1
ernie harper	GBR	Athletics	1
ernst fast	SWE	Athletics	1
ernst hoppenberg	DEU	Swimming	1
ernst schultz	DEN	Athletics	1
ervin hall	USA	Athletics	1
erwin sietas	GER	Swimming	1
erzsebet viski, kinga bota, katalin kovacs, szilvia szabo	HUN	Canoeing	1
eshetu tura	ETH	Athletics	1
eskild ebbesen, kasper winther, jacob barsoe, morten jorgensen	DEN	Rowing	1
eskild ebbesen, thomas ebert, victor feddersen, soren madsen	DEN	Rowing	1
ethelda bleibtrey	USA	Swimming	1
ethel lackie	USA	Swimming	1
ethel smith	CAN	Athletics	1
etienne dagon	SUI	Swimming	1
etienne gailly	BEL	Athletics	1
euphrasia donnelly, ethel lackie, gertrude ederle, mariechen wehselau	USA	Swimming	1
eva-maria ten elsen	GER	Swimming	1
eva risztov	HUN	Swimming	1
evelyn ashford	USA	Athletics	2
evelyn kawamoto	USA	Swimming	1
evelyn kawamoto, joan alderson, marilee stepan, jacqueline lavine	USA	Swimming	1
everard butler	CAN	Rowing	1
evgeny korotyshkin	RUS	Swimming	1
evgeny lagunov, nikita lobintsev, mikhail polishchuk, danila izotov, alexander sukhorukov	RUS	Swimming	1
ewa klobukowska	POL	Athletics	1
ewa klobukowska, halina g?recka-richter, teresa ciepla, irena szewinska	POL	Athletics	1
ezekiel kemboi	KEN	Athletics	2
fabien gilot, amaury leveaux, clement lefert, yannick agnel	FRA	Swimming	1
faith leech	AUS	Swimming	1
falilat ogunkoya	NGR	Athletics	1
fani halkia	GRE	Athletics	1
fanny blankers-koen	NED	Athletics	2
fanny durack	ANZ	Swimming	1
fanny rosenfeld	CAN	Athletics	1
fatuma roba	ETH	Athletics	1
fay moulton	USA	Athletics	1
federica pellegrini	ITA	Swimming	2
felipe m??oz	MEX	Swimming	1
felix sanchez	DOM	Athletics	2
ferenc csik	HUN	Swimming	1
ferenc moh?csi, k?roly wieland	HUN	Canoeing	1
ferenc novak, imre pulai	HUN	Canoeing	1
fermin cacho	ESP	Athletics	2
fernanda ribeiro	POR	Athletics	2
fernando scherer	BRA	Swimming	1
fie udby erichsen	DEN	Rowing	1
filbert bayi	TAN	Athletics	1
filippo soffici, alessandro corona, gianluca farina, rossano galtarossa	ITA	Rowing	1
fita bayissa	ETH	Athletics	1
fita lovin	ROM	Athletics	1
florence griffith-joyner	USA	Athletics	3
florent manaudou	FRA	Swimming	1
florian schwarthoff	GER	Athletics	1
florin popescu, mitica pricop	ROM	Canoeing	1
ford konno	USA	Swimming	2
ford konno, james mclane, wayne moore, william woolsey	USA	Swimming	1
forrest smithson	USA	Athletics	1
forrest towns	USA	Athletics	1
foy draper, ralph metcalfe, jesse owens, frank wykoff	USA	Athletics	1
francesco cossu, giliante d'este, antonio ghiardello, antonio garzoni provenzani	KIT	Rowing	1
francesco la macchia, aldo dezzi	ITA	Canoeing	1
frances schroth	USA	Swimming	1
frances schroth, ethelda bleibtrey, irene guest, margaret woodbridge	USA	Swimming	1
francine fox, glorianne perrier	USA	Canoeing	1
francis amyot	CAN	Canoeing	1
francisco javier fernandez	ESP	Athletics	1
francis hegerty, matthew ryan, james marburg, cameron mckenzie-mcharg	AUS	Rowing	1
francis kerbiriou, gilles bertould, jacques carette, roger v?lasquez	FRA	Athletics	1
francis lane	USA	Athletics	1
francis obikwelu	POR	Athletics	1
franjo mihalic	YUG	Athletics	1
frank baltrusch	GDR	Swimming	1
frank baumgartl	GDR	Athletics	1
frank beaurepaire	ANZ	Swimming	2
frank beaurepaire	AUS	Swimming	2
frank beaurepaire, william herald, henry hay, ivan stedman	AUS	Swimming	1
frank cuhel	USA	Athletics	1
frank esposito	FRA	Swimming	1
frank forberger, dieter grahn, dieter schubert, frank r?hle	GDR	Rowing	1
frank greer	USA	Rowing	1
frank hansen, svein th?gersen	NOR	Rowing	1
frankie fredericks	NAM	Athletics	4
frank jarvis	USA	Athletics	1
frank loomis	USA	Athletics	1
frank mckinney	USA	Swimming	2
frank mckinney, lance larson, jeffrey farrell, paul hait	USA	Swimming	1
frank pf?tze, detlev grabs, rainer strohbach, j?rg woithe	GDR	Swimming	1
frank saker, harvey charters	CAN	Canoeing	1
frank schaffer	GDR	Athletics	1
frank shorter	USA	Athletics	2
frank waller	USA	Athletics	2
frank wiegand	GER	Swimming	1
frank wiegand, roland matthes, eugen henninger, horst-g?nter gregor	GDR	Swimming	1
franziska van almsick	GER	Swimming	3
franziska van almsick, hannah stockbauer, antje buschschulte, petra dallmann, janina g?tz	GER	Swimming	1
franziska van almsick, sandra v?lker, simone osygus, kerstin kielga?, dagmar hase, meike freitag	GER	Swimming	1
fr?d?ric delcourt	FRA	Swimming	1
fred deburghgraeve	BEL	Swimming	1
freddie lane	AUS	Swimming	1
frederica van der goes, rhoda rennie, kathleen russell, marie bedford	SAF	Swimming	1
frederick murray	USA	Athletics	1
frederick pollard	USA	Athletics	1
frederick schule	USA	Athletics	1
frederick tyler, mark spitz, john kinsella, steven genter	USA	Swimming	1
fred holman	GBR	Swimming	1
fred kelly	USA	Athletics	1
fred moloney	USA	Athletics	1
fred newhouse	USA	Athletics	1
fred newhouse, maxie parks, benjamin brown, herman frazier	USA	Athletics	1
fred onyancha	KEN	Athletics	1
fred schmidt	USA	Swimming	1
fred schmidt, harold mann, steve clark, william craig	USA	Swimming	1
friedhelm wentzke, berni schulze, g?nter perleberg, holger zander	GER	Canoeing	1
fritz bondroit, ewald tilker	GER	Canoeing	1
fritz hofmann	DEU	Athletics	1
fritzi schwingl	AUT	Canoeing	1
gabi m?ller, sabine eichenberger, ingrid haralamow, daniela baumer	SUI	Canoeing	1
gabriela szabo	ROM	Athletics	3
gabriella dorio	ITA	Athletics	1
gabriella szab?, katalin kov?cs, danuta koz?k, natasa janics	HUN	Canoeing	1
gabriel tiacoh	CIV	Athletics	1
gail devers	USA	Athletics	2
gail neall	AUS	Swimming	1
galen rupp	USA	Athletics	1
galina alekseyeva-kreft, nina trofimova-gopova	URS	Canoeing	1
galina bukharina, lyudmila samotesova, vera popkova, lyudmila maslakova	URS	Athletics	1
galina malchugina, lyudmila kondratyeva, natalya pomoshchnikova, marina zhirova	URS	Athletics	1
galina stepanova-prozumenshchykova	URS	Swimming	5
gamze bulut	TUR	Athletics	1
garth manton, michael aikman, adrian monger, harold hewitt, james howden, walter howell, bryan doyle, angus benfield, david boykett	AUS	Rowing	1
gary chapman	AUS	Swimming	1
gary dilley	USA	Swimming	1
gary gullock, paul reedy, anthony lovrich, timothy mclaren	AUS	Rowing	1
gary hall	USA	Swimming	3
gary hall jr.	USA	Swimming	5
gary hall jr., ian crocker, nate dusing, jason lezak, michael phelps, gabe woodward, neil walker	USA	Swimming	1
gary ilman, don schollander, michael austin, steve clark	USA	Swimming	1
gary oakes	GBR	Athletics	1
gaston delaplane	FRA	Rowing	1
gaston giran, alfred pl?	FRA	Rowing	1
gaston godel	SUI	Athletics	1
gaston mercier, yves delacour, guy guillabert, ren? guissart	FRA	Rowing	1
gaston reiff	BEL	Athletics	1
gaston roelants	BEL	Athletics	1
gaston strobino	USA	Athletics	1
geert jan derksen, gerritjan eggenkamp, jan-willem gabriels, chun wei cheung, michiel bartman, matthijs vellenga, gijs vermeulen, diederik simon, daniel mensch	NED	Rowing	1
geertje wielema	NED	Swimming	1
gelindo bordin	ITA	Athletics	1
gennady bukarin	URS	Canoeing	1
gennady korshikov, aleksandr timoshinin	URS	Rowing	1
gennady prigoda	URS	Swimming	1
geoff huegill	AUS	Swimming	1
geoff stewart, james stewart, ben dodwell, bo hanson	AUS	Rowing	1
george bovell	TRI	Swimming	1
george breen	USA	Swimming	3
george breen, richard hanley, ford konno, william woolsey	USA	Swimming	1
george bridgewater, nathan twaddle	NZL	Rowing	1
george dicarlo	USA	Swimming	2
george dietz, august erker, albert nasse, arthur stockhoff	USA	Rowing	1
george harrison, richard blick, jeffrey farrell, michael troy	USA	Swimming	1
george hodgson	CAN	Swimming	2
george hungerford, roger jackson	CAN	Rowing	1
george hutson	GBR	Athletics	1
george kerr	BWI	Athletics	1
george kerr, keith gardner, james wedderburn, malcolm spence	BWI	Athletics	1
george kojac	USA	Swimming	1
george mackay, archibald black, colin finlayson, william wood	CAN	Rowing	1
george nash, william satch	GBR	Rowing	1
george orton	CAN	Athletics	1
george poage	USA	Athletics	1
george rhoden	JAM	Athletics	1
george rhoden, arthur wint, herb mckenley, leslie laing	JAM	Athletics	1
george saling	USA	Athletics	1
georges dransart, georges gandil	FRA	Canoeing	1
george simpson	USA	Athletics	1
georges piot, maurice bouton	FRA	Rowing	1
georges vallerey	FRA	Swimming	1
georgeta damian, viorica susanu	ROM	Rowing	1
george vernot	CAN	Swimming	2
george young	USA	Athletics	1
georgina bardach	ARG	Swimming	1
georg lammers	GER	Athletics	1
georgy prokopenko	URS	Swimming	1
gerald ashworth, paul drayton, bob hayes, richard stebbins	USA	Athletics	1
gerard nijboer	NED	Athletics	1
gerhard boetzelen, herbert buhtz	GER	Rowing	1
gerhard hennige	FRG	Athletics	1
gerhard hetz	GER	Swimming	1
gerhard hetz, hans-joachim klein, uwe jacobsen, horst-g?nter gregor, frank wiegand	GER	Swimming	1
germain chardin, dorian mortelette	FRA	Rowing	1
gert fredriksson	SWE	Canoeing	4
gert fredriksson, sven-olof sj?delius	SWE	Canoeing	1
gertrude ederle	USA	Swimming	2
gertrude liebhart	AUT	Canoeing	1
gete wami	ETH	Athletics	3
gezahgne abera	ETH	Athletics	1
gheorghe simionov, gheorghe danilov	ROM	Canoeing	1
giancarlo crosta, renato bosatta, tullio baraglia, giuseppe galante	ITA	Rowing	1
gilbert bozon	FRA	Swimming	1
giovanni calabrese, nicola sartori	ITA	Rowing	1
giovanni de benedictis	ITA	Athletics	1
gisela arendt	GER	Swimming	1
giuseppe moioli, elio morille, giovanni invernizzi, franco faggi	ITA	Rowing	1
giuseppina leone	ITA	Athletics	1
gladys carson	GBR	Swimming	1
glen housman	AUS	Swimming	1
glenn beringen	AUS	Swimming	1
glenn buchanan	SUR	Swimming	1
glenn cunningham	USA	Athletics	1
glenn davis	USA	Athletics	2
glenn davis, otis davis, jack yerman, earl young	USA	Athletics	1
glenn hardin	USA	Athletics	2
glenroy gilbert, robert esmie, donovan bailey, bruny surin	CAN	Athletics	1
gloria siebert	GDR	Athletics	1
glory alozie	NGR	Athletics	1
?gnes kov?cs	HUN	Swimming	2
g?nther pfaff, gerhard seibold	AUT	Canoeing	1
godfrey brown	GBR	Athletics	1
godfrey brown, godfrey rampling, william roberts, freddie wolff	GBR	Athletics	1
gordon pirie	GBR	Athletics	1
gottfried kottmann	SUI	Rowing	1
grace jackson	JAM	Athletics	1
graeme brewer	AUS	Swimming	1
graeme smith	GBR	Swimming	1
graham windeatt	AUS	Swimming	1
g?ran larsson	SWE	Swimming	1
grant davies	AUS	Canoeing	1
grant hackett	AUS	Swimming	4
grant hackett, michael klim, todd pearson, antony matkovich, nicholas sprenger, craig stevens, ian thorpe	AUS	Swimming	1
grant hackett, nick ffrost, leith brodie, grant brits, patrick murphy, kirk palmer	AUS	Swimming	1
grantley goulding	GBR	Athletics	1
g?rard blitz	BEL	Swimming	1
gratsian botev, pavel kharin	URS	Canoeing	1
greg barton	USA	Canoeing	3
greg barton, norman bellingham	USA	Canoeing	1
greg foster	USA	Athletics	1
greg haughton	JAM	Athletics	1
gregor hradetzky	AUT	Canoeing	1
gregory brough	AUS	Swimming	1
gregory buckingham	USA	Swimming	1
gregory burgess	USA	Swimming	1
gregory fasala, michael delany, neil brooks, mark stockwell	AUS	Swimming	1
gregory rogers, robert windle, graham white, michael wenden	AUS	Swimming	1
greta andersen	DEN	Swimming	1
greta andersen, fritze carstensen-nathansen, karen harup, eva riise-arndt	DEN	Swimming	1
grete waitz	NOR	Athletics	1
grigore obreja, gheorghe andriev	ROM	Canoeing	1
grzegorz kotowicz, dariusz bialkowski	POL	Canoeing	1
g?te hagstr?m	SWE	Athletics	1
guanliang meng, wenjun yang	CHN	Canoeing	1
gudrun beckmann, jutta weber, heidemarie reineck, angela steinbach	FRG	Swimming	1
gudrun wegner	GDR	Swimming	1
guillaume leblanc	CAN	Athletics	1
guillermo del riego, herminio men?ndez	ESP	Canoeing	1
guillermo douglas	URU	Rowing	1
gunhild hoffmeister	GDR	Athletics	3
gunnar h?ckert	FIN	Athletics	1
gunnar larsson	SWE	Swimming	2
gunnar olsson, karl sundqvist	SWE	Canoeing	1
gunnar utterberg, sven-olof sj?delius	SWE	Canoeing	1
gustav jansson	SWE	Athletics	1
gustavo fran?a borges	BRA	Swimming	3
gustavo fran?a borges, carlos jayme, fernando scherer, edvaldo silva filho	BRA	Swimming	1
gustav sch?fer	GER	Rowing	1
guy butler	GBR	Athletics	2
guy butler, edward toms, george renwick, richard ripley, cecil griffiths, robert lindsay, john ainsworth-davis, guy butler	GBR	Athletics	1
guy drut	FRA	Athletics	2
gwendoline porter, eileen hiscock, nellie halstead, violet webb	GBR	Athletics	1
gwen torrence	USA	Athletics	2
gwen torrence, carlette guidry, esther jones, evelyn ashford	USA	Athletics	1
gyorgy kozmann, gy?rgy kolonics	HUN	Canoeing	1
gy?rgy kolonics	HUN	Canoeing	1
gy?rgy mitr?	HUN	Swimming	1
gy?rgy mitr?, imre ny?ki, g?za k?das, elem?r szathm?ry	HUN	Swimming	1
gy?rgy m?sz?ros, andr?s szente	HUN	Canoeing	1
gy?rgy sarl?s, antal melis, zolt?n melis, j?zsef csermely	HUN	Rowing	1
gy?rgy tumpek	HUN	Swimming	1
gy?rgy zala	HUN	Canoeing	2
gyula kellner	HUN	Athletics	1
gyula petrikovics, tam?s wichmann	HUN	Canoeing	1
g?za csap?	HUN	Canoeing	2
g?za k?das	HUN	Swimming	1
habiba ghribi	TUN	Athletics	1
hadi souan somayli	KSA	Athletics	1
haile gebrselassie	ETH	Athletics	2
haley anderson	USA	Swimming	1
halimat ismaila, franca idoko, gloria kemasuode, oludamola osayomi, agnes osazuwa	NGR	Athletics	1
halina g?recka-richter, teresa ciepla, barbara janiszewska, celina jesionowska	POL	Athletics	1
hannelore anke	GDR	Swimming	1
hannes kolehmainen	FIN	Athletics	3
hanns braun	DEU	Athletics	2
hanny termeulen	NED	Swimming	1
hanny termeulen, koosje van voorn, marie-louise linssen-vaessen, irma heijting-schuhmacher	NED	Swimming	1
hans berglund, lennart klingstr?m	SWE	Canoeing	1
hans dam	DEN	Swimming	1
hans fa?nacht, werner lampe, hans-g?nter vosseler, klaus steinbach	FRG	Swimming	1
hans-georg reimann	GDR	Athletics	2
hans grodotzki	GER	Athletics	2
hans-joachim hannemann, heinz kaufmann, hans kuschke, herbert schmidt, werner loeckle, wilhelm mahlow, helmut radach, alfred rieck, gerd v?ls	GER	Rowing	1
hans-joachim klein	GER	Swimming	1
hans-joachim klein, horst l?ffler, frank wiegand	GER	Swimming	1
hansj?rg kunze	GDR	Athletics	1
hans kalt, josef kalt	SUI	Rowing	1
hans kalt, kurt schmid	SUI	Rowing	1
hansle parchment	JAM	Athletics	1
hans magnus grepperud, sverre l?ken	NOR	Rowing	1
hans maier, karl aletter, walter flinsch, ernst gaber	GER	Rowing	1
hanson, viinberg, guloien, wilkinson, mastracci, brzozowicz, marquardt, morin, thompson-willie	CAN	Rowing	1
hans sennewald, thorsten streppelhoff, bahne rabe, frank richter, detlef kirchhoff, manfred klein, armin eichholz, roland baar, ansgar wessling	GER	Rowing	1
hans walter, emile albrecht, alfred probst, eugen sigg-b?chthold	SUI	Rowing	1
harald julin	SWE	Swimming	1
harald norpoth	GER	Athletics	1
harald schmid	FRG	Athletics	1
harald schmid, lothar krieg, bernd herrmann, franz-peter hofmeister	FRG	Athletics	1
harold abrahams	GBR	Athletics	1
harold barker, john fenning, philip filleul, gordon thomson, albertus wielsma, geoffrey taylor, hermanus h?fte, charles riddy, becher robert gale, bernardus croon, gordon balfour, johan burk	NED	Rowing	1
harold barron	USA	Athletics	1
harold hardwick	ANZ	Swimming	2
harold west, arthur sulley, guy nickalls, gordon killick, harold lane, jack beresford, john badcock, donald gollan, james hamilton	GBR	Rowing	1
harold whitlock	GBR	Athletics	1
harold wilson	GBR	Athletics	1
harrison dillard	USA	Athletics	2
harrison dillard, barney ewell, melvin patton, lorenzo wright	USA	Athletics	1
harrison dillard, lindy remigino, andy stanfield, dean smith	USA	Athletics	1
harry blackstaffe	GBR	Rowing	1
harry davel, bevil rudd, clarence oldfield, jack oosterlaak	SAF	Athletics	1
harry edward	GBR	Athletics	2
harry hebner	USA	Swimming	1
harry hebner, ken huszagh, perry mcgillivray, duke kahanamoku	USA	Swimming	1
harry hillman	USA	Athletics	3
harry jerome	CAN	Athletics	1
harry larva	FIN	Athletics	1
harry lott, frank schell, louis abell, michael gleason, john exley, james flanagan, frederick cresser, joseph dempsey, charles armstrong	USA	Rowing	1
hartwig gauder	GDR	Athletics	2
harvey glance, millard hampton, john jones, steven riddick	USA	Athletics	1
hasely crawford	TRI	Athletics	1
hasna benhassi	MAR	Athletics	2
hassiba boulmerka	ALG	Athletics	1
hayden stoeckel	AUS	Swimming	1
hayes jones	USA	Athletics	2
hayley lewis	AUS	Swimming	2
heather armitage, june foulds-paul, anne pashley, jean scrivens	GBR	Athletics	1
heather hunte, sonia lannaman, beverley goddard-callender, kathryn smallwood-cook	GBR	Athletics	1
heather stanning, helen glover	GBR	Rowing	1
hec hogan	AUS	Athletics	1
heidemarie reineck, silke pielen, gudrun beckmann, vreni eberle	FRG	Swimming	1
heidemarie reineck, uta frommater, angelika kraus, heike hustede	FRG	Swimming	1
heide rosendahl, annegret richter, christiane krause, ingrid mickler-becker	FRG	Athletics	1
heike d?hne	GDR	Swimming	1
heike drechsler	GDR	Athletics	2
heike friedrich	GDR	Swimming	2
heike schulte-mattler, ute thimm, heide-elke gaugel, gaby bu?mann	FRG	Athletics	1
heini thoma, rudolf bosshard	SUI	Rowing	1
heinz b?ker, holger zander	GER	Canoeing	1
heinz ulzheimer	GER	Athletics	1
heinz ulzheimer, g?nther steines, hans geister, karl-friedrich haas	GER	Athletics	1
helene madison	USA	Swimming	2
helen gordon	GBR	Swimming	1
helen johns, eleanor garatti-saville, helene madison, josephine mckim	USA	Swimming	1
helen stephens	USA	Athletics	1
helen stephens, annette rogers, elizabeth robinson, harriet bland	USA	Athletics	1
helen varcoe, edna hughes, joyce cooper, elizabeth davies	GBR	Swimming	1
helen wainwright	USA	Swimming	1
helga klein, ursula knab, marie sander, marga petersen	GER	Athletics	1
helga lindner	GDR	Swimming	1
helge halkj?r, aksel hansen, ib storm larsen, helge schr?der	DEN	Rowing	1
helmut c?mmerer	GER	Canoeing	1
helmuth k?rnig	GER	Athletics	1
henk-jan zwolle, nico rienks	NED	Rowing	1
henning jakobsen	DEN	Canoeing	2
henri barrelet	FRA	Rowing	1
henri deloge	FRA	Athletics	1
henri eberhardt	FRA	Canoeing	1
henri jan wienese	NED	Rowing	1
henrik nilsson, markus oscarsson	SWE	Canoeing	2
henri tauzin	FRA	Athletics	1
henry carr	USA	Athletics	1
henry eriksson	SWE	Athletics	1
henry jonsson	SWE	Athletics	1
henry stallard	GBR	Athletics	1
henry taylor	GBR	Swimming	4
henry taylor, edward peter, harold annison, leslie savage	GBR	Swimming	1
herb elliott	AUS	Athletics	1
herbert haresnape	GBR	Swimming	1
herbert jamison	USA	Athletics	1
herbert klein	GER	Swimming	1
herbert schade	GER	Athletics	1
herb mckenley	JAM	Athletics	3
herman frazier	USA	Athletics	1
herman groman	USA	Athletics	1
hermann betschart, hans homberger, alex homberger, karl schmid	SUI	Rowing	1
hermann engelhard	GER	Athletics	1
hermann engelhard, otto neumann, richard krebs, harry storz	GER	Athletics	1
hermine stindt, louise otto, grete rosenberg, vally dressel	DEU	Swimming	1
herminio men?ndez, luis miguez	ESP	Canoeing	1
hezekiah nyamau, daniel rudisha, charles asati, naftali bon	KEN	Athletics	1
hezekiel sepeng	RSA	Athletics	1
hicham el guerrouj	MAR	Athletics	3
hideko maehata	JPN	Swimming	2
hilda strike	CAN	Athletics	1
hilda strike, mary frizzel, mildred frizzel, lillian palmer	CAN	Athletics	1
hildegard falck	FRG	Athletics	1
hilde lauer	ROM	Canoeing	1
hilde schrader	GER	Swimming	1
hiroshi suzuki	JPN	Swimming	1
hisayoshi sato, junichi miyashita, kosuke kitajima, takuro fujii	JPN	Swimming	1
h?kan malmroth	SWE	Swimming	1
hong qian	CHN	Swimming	2
horace ashenfelter	USA	Athletics	1
horacio podest?, julio curatella	ARG	Rowing	1
horatio fitch	USA	Athletics	1
horst-g?nter gregor, eugen henninger, hans-joachim klein, ernst-joachim k?ppers	GER	Swimming	1
howard valentine	USA	Athletics	1
huali lu, xiaoli gu	CHN	Rowing	1
hugh edwards, jack beresford, john badcock, roland george	GBR	Rowing	1
hugh fisher, alwyn morris	CAN	Canoeing	1
hugo kusick	EST	Rowing	1
hugo strau?, willi eichhorn	GER	Rowing	1
hugues duboscq	FRA	Swimming	3
huina xing	CHN	Athletics	1
ian crocker	USA	Swimming	1
ian crocker, brendan hansen, mark gangloff, jason lezak, lenny krayzelburg, aaron peirsol, michael phelps, neil walker	USA	Swimming	1
ian ferguson	NZL	Canoeing	1
ian ferguson, grant bramwell, paul macdonald, alan thompson	NZL	Canoeing	1
ian ferguson, paul macdonald	NZL	Canoeing	2
ian o'brien	AUS	Swimming	1
ian o'brien, david dickson, kevin berry, peter reynolds	AUS	Swimming	1
ian stewart	GBR	Athletics	1
ian thorpe	AUS	Swimming	5
ian thorpe, todd pearson, daniel kowalski, michael klim, william kirby, grant hackett	AUS	Swimming	1
ian wynne	GBR	Canoeing	1
ib ivan larsen, peter christiansen	DEN	Rowing	1
ibrahim rojas, ledys frank balceiro	CUB	Canoeing	1
igor buldakov, viktor ivanov	URS	Rowing	1
igor francetic, tihomir frankovic, igor boraska, kresimir culjak, branimir vujevic, niksa skelin, sinisa skelin, tomislav smoljanovic, silvijo petrisko	CRO	Rowing	1
igor pisarev	URS	Canoeing	1
igor polyansky	URS	Swimming	2
igor yemchuk, georgy zhilin	URS	Rowing	1
ileana silai	ROM	Athletics	1
ilmari salminen	FIN	Athletics	1
ilse kaschube, petra grabowski	GDR	Canoeing	1
ilya markov	RUS	Athletics	1
imre farkas, andr?s istv?n t?r?	HUN	Canoeing	1
imre pulai	HUN	Canoeing	1
imre sz?ll?si	HUN	Canoeing	1
imre sz?ll?si, csaba giczi, istv?n csizmadia, istv?n tim?r	HUN	Canoeing	1
ina beyermann	FRG	Swimming	1
ina beyermann, ute hasse, karin seick, svenja schlicht	FRG	Swimming	1
ina kleber	GDR	Swimming	1
ines diers	GDR	Swimming	4
ines diers, sarina h?lsenbeck, barbara krause, caren metschuck	GDR	Swimming	1
ines gei?ler	GDR	Swimming	1
inga gentzel	SWE	Athletics	1
inge de bruijn	NED	Swimming	6
inge dekker, femke heemskerk, ranomi kromowidjojo, manon van rooijen, marleen veldhuis, hinkelien schreuder	NED	Swimming	1
inge dekker, marleen veldhuis, femke heemskerk, ranomi kromowidjojo	NED	Swimming	1
inge helten	FRG	Athletics	1
inge helten, annegret kroninger, annegret richter, elvira po?ekel	FRG	Athletics	1
inge s?rensen	DEN	Swimming	1
ingo spelly, olaf heukrodt	GDR	Canoeing	1
ingo spelly, ulrich papke	GER	Canoeing	1
ingrid lange-auerswald	GDR	Athletics	1
ingrid lange-auerswald, marlies g?hr-oelsner, romy m?ller, b?rbel w?ckel-eckert	GDR	Athletics	1
ingrid lempereur	BEL	Swimming	1
ingrid schmidt, b?rbel fuhrmann, ursula brunner, ursula k?per	GER	Swimming	1
ingvar pettersson	SWE	Athletics	1
inna frolova, antonina dumcheva, irina kalimbet, svetlana mazy	URS	Rowing	1
inna frolova, olena ronzhina, diana miftakhutdinova, svetlana mazy	UKR	Rowing	1
inna osypenko	UKR	Canoeing	3
innocent egbunike, rotimi peters, moses ugbusie, sunday uti	NGR	Athletics	1
ion birladeanu	ROM	Canoeing	1
ionela tirlea-manolache	ROM	Athletics	1
ira davenport	USA	Athletics	1
irena szewinska	POL	Athletics	5
irene eijs, eeke van nes	NED	Rowing	1
irene guest	USA	Swimming	1
irina nazarova, tatyana prorochenko, tatyana goyshchik, nina zyuskova	URS	Athletics	1
irina privalova	RUS	Athletics	1
irina privalova	URS	Athletics	1
irnya lishchynska	UKR	Athletics	1
isabella ochichi	KEN	Athletics	1
ismail ahmedismail	SUD	Athletics	1
istv?n b?r?ny	HUN	Swimming	1
istv?n b?r?ny, l?szl? szabados, andr?s sz?kely, andr?s wani?	HUN	Swimming	1
istv?n hernek	HUN	Canoeing	1
istv?n jo?s, istv?n szab?	HUN	Canoeing	1
istv?n r?zsav?lgyi	HUN	Athletics	1
iuliia efimova	RUS	Swimming	1
ivan belyaev	URS	Athletics	1
ivan burchin, fedya damyanov	BUL	Canoeing	1
ivan garcia, jose angel cesar, luis alberto perez, freddy mayola	CUB	Athletics	1
ivano brugnetti	ITA	Athletics	1
ivan patzaichin	ROM	Canoeing	1
ivan patzaichin, petre capusta	ROM	Canoeing	1
ivan patzaichin, serghei covaliov	ROM	Canoeing	1
ivan patzaichin, toma simionov	ROM	Canoeing	3
ivan riley	USA	Athletics	1
ivan shtyl	RUS	Canoeing	1
ivans klementjevs	LAT	Canoeing	2
ivans klementjevs	URS	Canoeing	1
ivar stukolkin	URS	Swimming	1
ivar stukolkin, vladimir salnikov, andrey krylov, sergey koplyakov	URS	Swimming	1
ivo van damme	BEL	Athletics	2
ivo yanakiev	BUL	Rowing	1
izabella dylewska	POL	Canoeing	2
iztok cop, denis zvegelj	SLO	Rowing	1
iztok cop, luka spik	SLO	Rowing	3
jaap kraaier	NED	Canoeing	1
jack babashoff	USA	Swimming	1
jack beresford	GBR	Rowing	2
jack beresford, dick southwood	GBR	Rowing	1
jack davis	USA	Athletics	2
jack dearlove, chris barton, ernest bircher, maurice lapage, guy richardson, charles lloyd, paul massey, alfred mellows, david meyrick	GBR	Rowing	1
jack guest, joseph wright	CAN	Rowing	1
jack hand, john donnelly, frank fiddes, frederick hedges, jack murdock, athol meech, cyril norris, william ross, herbert richardson	CAN	Rowing	1
jack horsley	USA	Swimming	1
jack jarvis	GBR	Swimming	2
jack kelly	USA	Rowing	1
jack kelly, paul costello	USA	Rowing	2
jack london	GBR	Athletics	1
jack lovelock	NZL	Athletics	1
jack medica	USA	Swimming	2
jack pierce	USA	Athletics	1
jackson scholz	USA	Athletics	2
jack taylor	USA	Swimming	1
jacob clear, david smith, tate smith, murray stewart	AUS	Canoeing	1
jacob jensen, ejvind hansen	DEN	Canoeing	1
jake wetzel, barney williams, cameron baerg, thomas herschmiller	CAN	Rowing	1
james ball	CAN	Athletics	1
james cristy	USA	Swimming	1
james gathers	USA	Athletics	1
james godday, musa audu, saul weigopwa, enefiok udo-obong	NGR	Athletics	1
james juvenal	USA	Rowing	1
james lightbody	USA	Athletics	5
james luvalle	USA	Athletics	1
james magnussen	AUS	Swimming	1
james mcintosh, arthur mckinlay, john mckinlay, john welchli	USA	Rowing	1
james mclane	USA	Swimming	2
james rector	USA	Athletics	1
james soutter, cyril seedhouse, george nicol, ernest henley	GBR	Athletics	1
james thompson, john smith, sizwe ndlovu, matthew brittain	RSA	Rowing	1
james thompson, walter spence, garnet ault, frederik bourne	CAN	Swimming	1
james tomkins, drew ginn	AUS	Rowing	1
james wendell	USA	Athletics	1
james wilson	GBR	Athletics	1
jana henke	GER	Swimming	1
jana sorgers, katrin rutschow-stomporowski, kathrin boron, kerstin k?ppen	GER	Rowing	1
jana thieme, kathrin boron	GER	Rowing	1
jan brz?k-felix, bohumil kudrna	CZE	Canoeing	2
jan brz?k-felix, vladim?r syrov?tka	CZE	Canoeing	1
jane barkman	USA	Swimming	1
jane cederqvist	SWE	Swimming	1
janeene vickers	USA	Athletics	1
janel jorgensen, beth barr, tracey mcfarlane, mary wayte	USA	Swimming	1
jane saville	AUS	Athletics	1
jane swagerty	USA	Swimming	1
janet evans	USA	Swimming	5
janeth busienei	KEN	Athletics	1
jan henne	USA	Swimming	3
janice andrew	AUS	Swimming	1
janice andrew, dawn fraser, marilyn wilson, rosemary lassig	AUS	Swimming	1
jani sievinen	FIN	Swimming	1
janusz kusocieski	POL	Athletics	1
janusz mikolajczak, henryk budzinski	POL	Rowing	1
jaouad gharib	MAR	Athletics	1
jared tallent	AUS	Athletics	3
jarmila kratochv?lov?	CZE	Athletics	1
jason lezak	USA	Swimming	1
jason lezak, gary hall jr., anthony ervin, josh davis, neil walker, scott tucker	USA	Swimming	1
jason lezak, michael phelps, nathan adrian, matt grevers, cullen jones, benjamin wildman-tobriner, garrett weber-gale	USA	Swimming	1
jason read, bryan volpenhein, chris ahrens, wyatt allen, dan beery, pete cipollone, matt deakin, joseph hansen, beau hoopman	USA	Rowing	1
jason richardson	USA	Athletics	1
javier culson	PUR	Athletics	1
jean boiteux	FRA	Swimming	1
jean bouin	FRA	Athletics	1
jean-christophe rolland, michel andrieux	FRA	Rowing	1
jeannette campbell	ARG	Swimming	1
jean stewart	NZL	Swimming	1
jean taris	FRA	Swimming	1
jearl miles, marion jones, monique hennagan, latasha colander-richardson	USA	Athletics	1
jearl miles, natasha kaiser, rochelle stevens, gwen torrence	USA	Athletics	1
jed graef	USA	Swimming	1
jefferson perez	ECU	Athletics	1
jefferson p?rez	ECU	Athletics	1
jeff rouse	USA	Swimming	2
jelisaveta dementyeva	URS	Canoeing	1
jenna johnson	USA	Swimming	1
jennie fletcher	GBR	Swimming	1
jennie fletcher, isabella moore, annie speirs, irene steer	GBR	Swimming	1
jennifer lamy	AUS	Athletics	1
jennifer stoute, phylis smith, sandra douglas, sally gunnell	GBR	Athletics	1
jenny maakal	SAF	Swimming	1
jenny thompson	USA	Swimming	1
jenny thompson, amanda weir, kara lynn joyce, tara kirk, natalie coughlin, haley cope, amanda beard, rachel komisarz	USA	Swimming	1
jens kruppa, stev theloke, torsten spanneberg, thomas rupprath	GER	Swimming	1
jens-peter herold	GDR	Athletics	1
jeremy linn	USA	Swimming	1
jeremy wariner	USA	Athletics	2
jeremy wariner, angella taylor, reggie witherspoon, kerron clement, dave neville, lashawn merritt	USA	Athletics	1
jerry heidenreich	USA	Swimming	2
jerry heidenreich, david edgar, john murphy, mark spitz	USA	Swimming	1
jerzy ustupski, roger verey	POL	Rowing	1
jesse mashburn, tom courtney, lou jones, charles jenkins	USA	Athletics	1
jesse owens	USA	Athletics	2
jessica hardy, allison schmitt, missy franklin, lia neal	USA	Swimming	1
jessicah schipper	AUS	Swimming	2
jessica monroe, heather mcdermid, maria maunder, emma robinson, lesley thompson, tosha tsang, anna van der kamp, theresa luke, alison korn	CAN	Rowing	1
jessica monroe, marnie mcbean, brenda taylor, lesley thompson, kay worthington, kathleen heddle, megan delehanty, shannon crawford, kirsten barnes	CAN	Rowing	1
jevgenij shuklin	LTU	Canoeing	1
jiao liuyang	CHN	Swimming	1
ji li, jiaying pang, yu yang, yanwei xu, yingwen zhu	CHN	Swimming	1
jill sterkel	USA	Swimming	1
jill sterkel, wendy boglioli, shirley babashoff, kim peyton	USA	Swimming	1
jim fifer, duvall hecht	USA	Rowing	1
jim hines	USA	Athletics	1
jim montgomery	USA	Swimming	2
jimmy tremeer	GBR	Athletics	1
jim ryun	USA	Athletics	1
jingyi le	CHN	Swimming	2
jingyi le, yun nian, ying shan, na chao	CHN	Swimming	1
j?nis dalins	LAT	Athletics	1
j?nos parti	HUN	Canoeing	2
joachim b?chner	GER	Athletics	1
joachim b?hmer, hans-ullrich schmied	GDR	Rowing	1
joachim dreifke	GDR	Rowing	1
joachim ehrig, peter funnek?tter, franz held, wolfgang plottke	FRG	Rowing	1
joachim mattern, bernd olbricht	GDR	Canoeing	1
joachim pirsch, willi kaidel	GER	Rowing	1
joan benoit	USA	Athletics	1
joan harrison	SAF	Swimming	1
joanna hayes	USA	Athletics	1
joanne jackson	GBR	Swimming	1
joaquim cruz	BRA	Athletics	2
jocelyn delecour, paul genevay, bernard laidebeur, claude piquemal	FRA	Athletics	1
jochen mei?ner	FRG	Rowing	1
jochen reske, manfred kinder, johannes kaiser, carl kaufmann	GER	Athletics	1
jodie henry	AUS	Swimming	1
jodie henry, sarah ryan, petria thomas, lisbeth lenton, alice mills	AUS	Swimming	1
joe deloach	USA	Athletics	1
joe forshaw	USA	Athletics	1
joe hudepohl, douglas gjertsen, scott jaffe, daniel jorgensen, melvin stewart, jon olsen	USA	Swimming	1
joel lamela, andr?s sim?n, joel isasi, jorge aguilera	CUB	Athletics	1
joel sanchez	MEX	Athletics	1
joel shankle	USA	Athletics	1
johan andersen	DEN	Canoeing	1
johan kenkhuis, pieter van den hoogenband, marcel wouda, mark van der zijden, martijn zuijdweg	NED	Swimming	1
johanna klier-schaller	GDR	Athletics	2
johannes drost	NED	Swimming	1
johannes van dijk, henrikus tromp, hendrik offerhaus, walter middelberg, walter thijssen, ruud leegstra, roelof klein, hermanus brockmann, fran?oise brandt	NED	Rowing	1
john akii-bua	UGA	Athletics	1
john archer, john gregory, kenneth jones, alistair mccorquodale	GBR	Athletics	1
john bray	USA	Athletics	1
john campbell, sebastian earl, robin johnstone, richard lucas, walter james, ewart horsfall, ralph shove, guy nickalls, sidney swann	GBR	Rowing	1
john carlos	USA	Athletics	1
john collier	USA	Athletics	1
john cooper	GBR	Athletics	1
john cooper, robbie brightwell, timothy graham, adrian metcalfe	GBR	Athletics	1
john cornes	GBR	Athletics	1
john cregan	USA	Athletics	1
john daly	GBR	Athletics	1
john davies	AUS	Swimming	1
john davies	NZL	Athletics	1
john devitt	AUS	Swimming	2
john disley	GBR	Athletics	1
john fenning, gordon thomson	GBR	Rowing	1
john ferris	USA	Swimming	2
john garrels	USA	Athletics	1
john hatfield	GBR	Swimming	2
john hatfield, william foster, thomas battersby, henry taylor	GBR	Swimming	1
john hayes	USA	Athletics	1
john hencken	USA	Swimming	4
john hencken, jim montgomery, john naber, matt vogel	USA	Swimming	1
john hoben, james mcloughlin, john wells, joseph ravanack	USA	Rowing	1
john holland	NZL	Athletics	1
john hunter, tony hurt, dick joyce, trevor coker, simon dickie, athol earl, gary robertson, wybo veldman, lindsay wilson	NZL	Rowing	1
john kelly	USA	Rowing	1
john kinsella	USA	Swimming	1
john konrads	AUS	Swimming	2
john konrads, john devitt, david dickson, murray rose	AUS	Swimming	1
john landy	AUS	Athletics	1
john lecky, lorne loomer, william mckerlich, archibald mckinnon, glen mervyn, nelson kuhn, ignace d'hondt, sohen biln, donald arnold	CAN	Rowing	1
john ljunggren	SWE	Athletics	3
john loaring	CAN	Athletics	1
john marshall	AUS	Swimming	2
john mcgough	GBR	Athletics	1
john mclean	USA	Athletics	1
john mockton, doug hamilton, bruce ford, mike hughes	CAN	Rowing	1
john monckton	AUS	Swimming	1
john mulcahy, william varley, john joachim, john buerger	USA	Rowing	1
john murphy	USA	Swimming	1
john mykkanen	USA	Swimming	1
john naber	USA	Swimming	3
john naber, jim montgomery, bruce furniss, mike bruner	USA	Swimming	1
john nelson	USA	Swimming	2
john ngugi	KEN	Athletics	1
john norton	USA	Athletics	1
johnny gray	USA	Athletics	1
johnny weissmuller	USA	Swimming	3
johnny weissmuller, walter laufer, george kojac, austin clapp	USA	Swimming	1
john russell, ted nash, john james, william barry, hugh wardell-yerburgh	GBR	Rowing	1
john schmitt, paul mcdowell	USA	Rowing	1
john sherwood	GBR	Athletics	1
john smith, warren snyder, norman taylor, harold little, arthur bell, ivor campbell, william langford, robert hunter, william wallace	CAN	Rowing	1
john somers-smith, angus gillan, duncan mackinnon, collier cudmore	GBR	Rowing	1
john s?rensen, peer nielsen	DEN	Canoeing	1
john sumegi	AUS	Canoeing	1
john svanberg	SWE	Athletics	1
john terwilliger, andrew sudduth, christopher penny, walter lubsen, robert jaugstetter, charles clapp, thomas darling, earl borchelt, bruce ibbetson	USA	Rowing	1
john treacy	IRL	Athletics	1
john walker	NZL	Athletics	1
john wallace, bruce robertson, michael rascher, derek porter, terrence paul, robert marland, mike forgeron, andrew crosby, darren barber	CAN	Rowing	1
john wood	CAN	Canoeing	1
john woodruff	USA	Athletics	1
jolanda ceplak	SLO	Athletics	1
jolanda de rover	NED	Swimming	2
jo?l bettin, philippe renaud	FRA	Canoeing	1
jonathan smith, philip stekl, alan forney, david clark	USA	Rowing	1
jon drummond, maurice greene, brian lewis, bernard williams iii	USA	Athletics	1
jon drummond, tim harden, mike marsh, dennis mitchell	USA	Athletics	1
jon henricks	AUS	Swimming	1
jon olsen, brad schumacher, joe hudepohl, josh davis, ryan berube	USA	Swimming	1
jon olsen, matt biondi, joe hudepohl, thomas jager, shaun jordan	USA	Swimming	1
jon olsen, pablo morales, melvin stewart, melvin stewart, jeff rouse, nelson diebel, hans dersch, hans dersch, david berkoff, david berkoff, matt biondi, matt biondi	USA	Swimming	1
jon sieben	AUS	Swimming	1
jopie selbach, tini wagner, willie den ouden, rie mastenbroek	NED	Swimming	1
jorge llopart	ESP	Athletics	1
jos? abascal	ESP	Athletics	1
josefa idem	ITA	Canoeing	1
josefa idem, barbara sch?ttpelz	FRG	Canoeing	1
josefa idem guerrini	ITA	Canoeing	3
josef dolezal	CZE	Athletics	1
josef dostal, daniel havel, jan sterba, lukas trefil	CZE	Canoeing	1
josef hasen?hrl	AUT	Rowing	1
josef holecek	CZE	Canoeing	2
josef kloimstein, alfred sageder	AUT	Rowing	1
josef odlozil	CZE	Athletics	1
josef schneider	SUI	Rowing	1
joseph bottom	USA	Swimming	1
joseph de combe	BEL	Swimming	1
joseph guillemot	FRA	Athletics	2
josephine mckim	USA	Swimming	1
joseph keter	KEN	Athletics	1
joseph larran	FRA	Rowing	1
joseph mahmoud	FRA	Athletics	1
joseph mccluskey	USA	Athletics	1
joseph ryan, robert farnam	USA	Rowing	1
joseph verdeur	USA	Swimming	1
josh culbreath	USA	Athletics	1
josia thugwane	RSA	Athletics	1
jos? l?pez, herminio men?ndez, luis miguez, jos? esteban	ESP	Canoeing	1
jos? pedraza	MEX	Athletics	1
josy barthel	LUX	Athletics	1
joyce chepchumba	KEN	Athletics	1
joyce cooper	GBR	Swimming	2
jozef pribilinec	CZE	Athletics	1
j?rgen bertow, hans-ullrich schmied	GDR	Rowing	1
j?rgen eschert	GER	Canoeing	1
j?rgen straub	GDR	Athletics	1
j?rg hoffmann	GER	Swimming	1
j?rg lucke, heinz-j?rgen bothe	GDR	Rowing	1
j?rg pfeifer, alexander thieme, manfred kokot, klaus-dieter kurrat	GDR	Athletics	1
j?rg schmidt	GDR	Canoeing	1
j?rg woithe	GDR	Swimming	1
j?ri jaanson	EST	Rowing	1
j?ri lossmann	EST	Athletics	1
juan carlos zabala	ARG	Athletics	1
juan rodriguez, william jones	URU	Rowing	1
judi brown	USA	Athletics	1
judith amoore	AUS	Athletics	1
judit temes	HUN	Swimming	1
judy davies	AUS	Swimming	1
judy grinham	GBR	Swimming	1
judy playfair, lynette mcclements, janet steinbeck, lynette watson	AUS	Swimming	1
jules de bisschop, oscar decock, prosp?re bruggeman, maurice hemelsoet, oscar charles de somville, frank odberg, marcel lucien van crombrugge, alfred vanlandeghem, maurice verdonck	BEL	Rowing	1
jules ladoum?gue	FRA	Athletics	1
julia greville, emma johnson, susan o'neill, lise mackie, nicole stevenson	AUS	Swimming	1
julia michalska, magdalena fularczyk	POL	Rowing	1
julie mcdonald	AUS	Swimming	1
juliet cuthbert	JAM	Athletics	2
juliet cuthbert, michelle freeman, nikole mitchell, merlene ottey-page	JAM	Athletics	1
juliette haigh, rebecca scown	NZL	Rowing	1
julius kariuki	KEN	Athletics	1
julius korir	KEN	Athletics	1
julius sang	KEN	Athletics	1
june croft	GBR	Swimming	1
june croft, ann osgerby, margaret kelly, helen jameson	GBR	Swimming	1
june foulds-paul, jean desforges, sylvia cheeseman, heather armitage	GBR	Athletics	1
june maston, betty mckinnon, joyce king, shirley strickland	AUS	Athletics	1
junxia wang	CHN	Athletics	2
juraj tarr, michal riszdorfer, richard riszdorfer, erik vlcek	SLO	Canoeing	1
juris silovs, aleksandr kornelyuk, vladimir lovetsky, valery borzov	URS	Athletics	1
justin gatlin	USA	Athletics	3
justin lemberg	AUS	Swimming	1
justin norris	AUS	Swimming	1
justus smith, john stack, ralph purchase, david turner, ian turner, james hardy, george ahlgren, david brown, lloyd butler	USA	Rowing	1
jutta behrendt	GDR	Rowing	1
jutta heine	GER	Athletics	1
j?zsef deme, j?nos r?tkai	HUN	Canoeing	1
j?zsef kov?cs	HUN	Athletics	1
j?zsef szab?	HUN	Swimming	1
kaarlo maaninka	FIN	Athletics	2
kaitlin sandeno	USA	Swimming	3
kajetan broniewski	POL	Rowing	1
kalle tuominen	FIN	Athletics	1
karel lismont	BEL	Athletics	2
karen harup	DEN	Swimming	2
karen hoff	DEN	Canoeing	1
karen moe	USA	Swimming	1
karen moras	AUS	Swimming	1
karen phillips	AUS	Swimming	1
karin balzer	GDR	Athletics	1
karin nilsson, emy machnow, jane gylling, aina berg	SWE	Swimming	1
karin seick	FRG	Swimming	1
karl-friedrich haas	GER	Athletics	1
karl-heinrich von groddeck, hans-j?rgen wallbrecht, klaus aeffke, thomas ahrens, klaus behrens, klaus bittner, j?rgen schroeder, j?rgen plagemann, horst meyer	GER	Rowing	1
karl-heinrich von groddeck, klaus bittner, karl-heinz hopp, hans lenk, willi padge, frank schepke, kraft schepke, manfred rulffs, walter schr?der	GER	Rowing	1
karl ruberl	AUT	Swimming	2
karl warner, bill carr, edgar ablowich, ivan fuqua	USA	Athletics	1
karsten forsterling, james mcrae, daniel noonan, christopher morgan	AUS	Rowing	1
katalin kovacs, danuta kozak, gabriella timea szabo, krisztina fazekas	HUN	Canoeing	1
katalin kovacs, natasa janic	HUN	Canoeing	1
katalin sz?ke	HUN	Swimming	1
katharine merry	GBR	Athletics	1
katherine copeland, sophie hosking	GBR	Rowing	1
katherine grainger, anna watkins	GBR	Rowing	1
katherine grainger, guin batten, miriam batten, gillian lindsay	GBR	Rowing	1
kathleen ellis	USA	Swimming	2
kathleen heddle, marnie mcbean	CAN	Rowing	1
kathleen nord	GDR	Swimming	1
kathrin boron, manuela lutze, britta oppelt, stephanie schiller	GER	Rowing	1
kathrin d?rre	GDR	Athletics	1
kathrin mei?ner	GDR	Swimming	1
kathrin zimmermann	GDR	Swimming	1
kathryn smallwood-cook	GBR	Athletics	1
kathryn smallwood-cook, simmone jacobs, beverley goddard-callender, heather hunte	GBR	Athletics	1
kathy hammond	USA	Athletics	1
katie hoff	USA	Swimming	2
katie ledecky	USA	Swimming	1
katrin borchert	AUS	Canoeing	1
katrin borchert, anna wood	AUS	Canoeing	1
katrin borchert, birgit fischer, anke nothnagel-von seck, ramona portwich	GER	Canoeing	1
katrin rutschow-stomporowski	GER	Rowing	2
katrin wagner	GER	Canoeing	1
katsuo takaishi	JPN	Swimming	1
kay bluhm, torsten gutsche	GER	Canoeing	3
kaye hall	USA	Swimming	2
kazimierz zimny	POL	Athletics	1
kazuo tomita, keigo shimizu, yoshihiko osaki, koichi hirakida	JPN	Swimming	1
kee-chung sohn	JPN	Athletics	1
keena rothhammer	USA	Swimming	2
keith carter	USA	Swimming	1
kellie wells	USA	Athletics	1
kelly holmes	GBR	Athletics	3
kelvin graham, peter foster	AUS	Canoeing	1
kelvin graham, ramon andersson, ian rowling, steven wood	AUS	Canoeing	1
kenenisa bekele	ETH	Athletics	4
ken huszagh	USA	Swimming	1
kenji kimihara	JPN	Athletics	1
ken matthews	GBR	Athletics	1
kennedy mcarthur	SAF	Athletics	1
kenneth myers	USA	Rowing	1
kenneth walsh	USA	Swimming	1
kentaro kawatsu	JPN	Swimming	1
ken wallace	AUS	Canoeing	2
kerron clement	USA	Athletics	1
kerron stewart	JAM	Athletics	2
kerstin behrendt, marlies g?hr-oelsner, ingrid lange-auerswald, silke m?ller-gladisch	GDR	Athletics	1
kerstin kielga?	GER	Swimming	1
kerstin k?ppen, kathrin boron	GER	Rowing	1
kerstin m?ller, kristina mundt, birgit peter, sybille schmidt	GER	Rowing	1
kevan gosper, leon gregory, david lean, graham gipson	AUS	Athletics	1
kevin berry	AUS	Swimming	1
kevin young	USA	Athletics	1
khalid boulami	MAR	Athletics	1
khalid skah	MAR	Athletics	1
kharis yunichev	URS	Swimming	1
kieren perkins	AUS	Swimming	4
kiki caron	FRA	Swimming	1
kim batten	USA	Athletics	1
kim crow	AUS	Rowing	1
kim crow, brooke pratley	AUS	Rowing	1
kim gallagher	USA	Athletics	2
kim knudsen, rene poulsen	DEN	Canoeing	1
kim turner	USA	Athletics	1
kim vandenberg, julia smit, allison schmitt, christine marshall, katie hoff, caroline burckle, natalie coughlin	USA	Swimming	1
kinue hitomi	JPN	Athletics	1
kipchoge keino	KEN	Athletics	4
kipkemboi kimeli	KEN	Athletics	1
kirani james	GRN	Athletics	1
kirk baptiste	USA	Athletics	1
kirsten emmelmann, sabine busch, petra m?ller, dagmar neubauer-r?bsam	GDR	Athletics	1
kirsten thomson, jacinta van lint, elka graham, petria thomas, susan o'neill, giaan rooney	AUS	Swimming	1
kirsten van der kolk, marit van eupen	NED	Rowing	2
kirsten vlieghuis	NED	Swimming	2
kirsty conventry	ZIM	Swimming	3
kirsty coventry	ZIM	Swimming	4
kjersti plaetzer	NOR	Athletics	1
kjersti platzer	NOR	Athletics	1
kjetil undset, steffen st?rseth	NOR	Rowing	1
klaus ehl, jobst hirscht, karlheinz klotz, gerhard wucherer	FRG	Athletics	1
klaus kr?ppelien, joachim dreifke	GDR	Rowing	1
klaus-peter hildenbrand	FRG	Athletics	1
klaus richtzenhain	GER	Athletics	1
klaus thiele, frank schaffer, volker beck, andreas knebel	GDR	Athletics	1
klemie bimolt, ada kok, erica terpstra, korrie winkel	NED	Swimming	1
klete keller	USA	Swimming	2
kl?ra rajnai	HUN	Canoeing	1
kl?ra rajnai, anna pfeffer	HUN	Canoeing	1
knut holmann	NOR	Canoeing	6
knut lindberg, charles luther, ivan m?ller, ture persson	SWE	Athletics	1
koichi morishita	JPN	Athletics	1
kokichi tsuburaya	JPN	Athletics	1
konrad wasielewski, michal jelinski, marek kolbowicz, adam korol	POL	Rowing	1
konstantinos kenteris	GRE	Athletics	1
kornelia ender	GDR	Swimming	4
kosuke hagino	JPN	Swimming	1
kosuke kitajima	JPN	Swimming	4
kosuke kitajima, takeshi matsuda, takuro fujii, ryosuke irie	JPN	Swimming	1
kriss akabusi	GBR	Athletics	1
kriss akabusi, todd bennett, phil brown, garry cook	GBR	Athletics	1
kristian hellstr?m	SWE	Athletics	1
kristina mundt, beate schramm, jana sorgers, kerstin f?rster	GDR	Rowing	1
kristin otto	GDR	Swimming	4
kristoffer leps?, thor pedersen, leif n?ss, carl henrik monssen, sigurd monssen, harald kr?kenes, thorstein kr?kenes, hans eigil hansen, halfdan gran olsen	NOR	Rowing	1
kristy kowal	USA	Swimming	1
krisztian bartfai, krisztian vereb	HUN	Canoeing	1
krisztina egerszegi	HUN	Swimming	7
k?roly bartha	HUN	Swimming	1
k?roly g?ttler	HUN	Swimming	2
k?roly levitzky	HUN	Rowing	1
kruska larsen	NOR	Athletics	1
k?the krau?	GER	Athletics	1
kurt grote, josh davis, mark henderson, gary hall jr., john hargis, jeremy linn, jeff rouse, tripp schwenk	USA	Swimming	1
kurt malisch	DEU	Swimming	1
kurt moeschter, bruno m?ller	GER	Rowing	1
kusuo kitamura	JPN	Swimming	1
kyoko iwasaki	JPN	Swimming	1
lacey hearn	USA	Athletics	1
laimute baikauskaite	URS	Athletics	1
lajos kiss	HUN	Canoeing	1
lalka berberova, radka stoyanova	BUL	Rowing	1
lalonde gordon	TTO	Athletics	1
lalonde gordon, deon lendore, jarrin solomon, ade alleyne-forte	TTO	Athletics	1
lance larson	USA	Swimming	1
larion serghei, policarp malihin	ROM	Canoeing	1
larisa kruglova, irina khabarova, olga fyodorova, yuliya tabakova	RUS	Athletics	1
larisa merk, oxana dorodnova, irina fedotova, ioulia levina	RUS	Rowing	1
larry black	USA	Athletics	1
larry cain	CAN	Canoeing	2
larry james	USA	Athletics	1
larry young	USA	Athletics	2
lars bj?nness, rolf thorsen, kjetil undset, per s?tersdal	NOR	Rowing	1
larsen jensen	USA	Swimming	2
lars-erik moberg	SWE	Canoeing	1
lars-erik moberg, per-inge bengtsson	SWE	Canoeing	1
lars fr?lander	SWE	Swimming	1
lars fr?lander, anders holmertz, anders lyrbring, christer wallin	SWE	Swimming	1
lars kober, stefan utess	GER	Canoeing	1
lars wolfbrandt, kurt lundqvist, rune larsson, folke alnevik	SWE	Athletics	1
lashawn merritt	USA	Athletics	1
lashinda demus	USA	Athletics	1
lasse vir?n	FIN	Athletics	4
laszlo cseh	HUN	Swimming	5
laurel korholz, samantha magee, anna mickelson, lianne nelson, mary whipple, megan dirkmaat, kate johnson, caryn davies, alison cox	USA	Rowing	1
laure manaudou	FRA	Swimming	3
lauri lehtinen	FIN	Athletics	2
lauri nevalainen, oiva lommi, veikko lommi, kauko wahlsten	FIN	Rowing	1
lauri siering, camille wright, shirley babashoff, linda jezek	USA	Swimming	1
lauri virtanen	FIN	Athletics	2
lauryn williams	USA	Athletics	1
lavonna martin	USA	Athletics	1
lea loveless	USA	Swimming	1
leamon king, thane baker, bobby morrow, ira murchison	USA	Athletics	1
ledys frank balceiro	CUB	Canoeing	1
lee calhoun	USA	Athletics	2
lee evans	USA	Athletics	1
lee evans, ron freeman, larry james, vincent matthews	USA	Athletics	1
leendert van dis, henricus droog	NED	Rowing	1
leisel jones	AUS	Swimming	5
leisel jones, alicia coutts, melanie schlanger, emily seebohm	AUS	Swimming	1
leni lohmar, gisela arendt, ruth halbsguth, inge schmitz	GER	Swimming	1
lennart strand	SWE	Athletics	1
lennox miller	JAM	Athletics	2
lenny krayzelburg	USA	Swimming	2
lenore kight-wingard	USA	Swimming	2
leobaldo pereira, ibrahim rojas	CUB	Canoeing	1
leonel manzano	USA	Athletics	1
leonid bartenev, yuri konovalov, gusman kosanov, edvins ozolins	URS	Athletics	1
leonid geyshtor, sergey makarenko	URS	Canoeing	1
leonid ilyichov, vladimir kosinsky, vladimir nemshilov	URS	Swimming	1
leonid spirin	URS	Athletics	1
leon rotman	ROM	Canoeing	2
les carney	USA	Athletics	1
lesley ashburner	USA	Athletics	1
leslie cliff	CAN	Swimming	1
leslie rich, harry hebner, leo goodwin, charles daniels	USA	Swimming	1
leszek dunecki, zenon licznerski, marian woronin, krzysztof zwoliwski	POL	Athletics	1
lewis clive, hugh edwards	GBR	Rowing	1
lewis tewanima	USA	Athletics	1
liam heath, jon schofield	GBR	Canoeing	1
libby trickett	AUS	Swimming	2
lida van der anker-doedens	NED	Canoeing	1
lidia simon	ROM	Athletics	1
liliana gafencu, elena georgescu, vera cochelea, doina ignat, elisabeta lipa, anca tanase, doina spircu, marioara popescu, ioana olteanu	ROM	Rowing	1
li lin	CHN	Swimming	4
liliya nurutdinova	URS	Athletics	1
lillian board	GBR	Athletics	1
limin liu	CHN	Swimming	1
lina kaciusyte	URS	Swimming	1
lina radke	GER	Athletics	1
linda gustavson	USA	Swimming	2
linda mackenzie, melanie schlanger, stephanie rice, kylie palmer, lara davenport, angie bainbridge, bronte barratt, felicity galvez	AUS	Swimming	1
lindsay burns, teresa bell	USA	Rowing	1
lindsay wilson, ivan sutherland, dave rodger, alex mclean, trevor coker, simon dickie, peter dignan, athol earl, tony hurt	NZL	Rowing	1
lindy remigino	USA	Athletics	1
linford christie	GBR	Athletics	2
linsey macdonald, michelle probert, joslyn hoyte-smith, donna-marie hartley	GBR	Athletics	1
liping wang	CHN	Athletics	1
lisa carrington	NZL	Canoeing	1
lisa jacob, trina jackson, sheila taormina, cristina teuscher, annette salmeen, ashley whitney, jenny thompson	USA	Swimming	1
lisa martin	AUS	Athletics	1
lisbeth lenton	AUS	Swimming	1
liuyang jiao	CHN	Swimming	1
liu zige	CHN	Swimming	1
livio berruti	ITA	Athletics	1
llewellyn herbert	RSA	Athletics	1
lloyd labeach	PAN	Athletics	2
lord david burghley	GBR	Athletics	1
lord david burghley, thomas hampson, godfrey rampling, crew stoneley	GBR	Athletics	1
lorenzo carboncini, riccardo deirossi, valter molea, carlo mornati	ITA	Rowing	1
lori melien, andrea nugent, jane kerr, allison higson	CAN	Swimming	1
lorraine crapp	AUS	Swimming	2
lorraine graham	JAM	Athletics	1
lorraine moller	NZL	Athletics	1
lothar kn?rzer, heinz f?tterer, manfred germar, leo pohl	GER	Athletics	1
lotte friis	DEN	Swimming	1
lotte m?he	GER	Swimming	1
louis clarke, frank hussey, alfred leconey, loren murchison	USA	Athletics	1
louise j?hncke, anna-karin kammerling, josefin lillhage, therese alshammar, malin svahnstrom, johanna sj?berg	SWE	Swimming	1
louis gantois	FRA	Canoeing	1
l?szl? folt?n, istv?n vaskuti	HUN	Canoeing	1
luca sacchi	ITA	Swimming	1
lucy morton	GBR	Swimming	1
lucyna langer	POL	Athletics	1
ludmila engquist	SWE	Athletics	1
ludy langer	USA	Swimming	1
luguelin santos	DOM	Athletics	1
luigi beccali	KIT	Athletics	2
luis las?rtegui, fernando climent	ESP	Rowing	1
lutz altepost, norman brockl, bjorn hogel goldschmidt, torsten eckbrett	GER	Canoeing	1
lutz ulbricht, niko ott, horst meyer, j?rg siebert, g?nther tiersch, dirk schreyer, r?diger henning, egbert hirschfelder, wolfgang hottenrott	FRG	Rowing	1
lyndon ferns, roland schoeman, ryk neethling, darian townsend	RSA	Swimming	1
lyndsie fogarty, hannah davis, chantal meek, lisa oldenhof	AUS	Canoeing	1
lynette mcclements	AUS	Swimming	1
lynn burke	USA	Swimming	1
lynn colella	USA	Swimming	1
lynn jennings	USA	Athletics	1
lynn vidali	USA	Swimming	2
lyubomir lyubenov	BUL	Canoeing	2
lyubomir petrov, ivo rusev, mincho nikolov, bogdan dobrev	BUL	Rowing	1
lyubov rusanova	URS	Swimming	2
lyudmila bragina	URS	Athletics	1
lyudmila dzhigalova, olga bryzgina, yelena ruzina, olga nazarova	URS	Athletics	1
lyudmila kondratyeva	URS	Athletics	1
lyudmila maslakova, natalya bochina, vera anisimova, vera komisova	URS	Athletics	1
lyudmila pinayeva-khvedosyuk	URS	Canoeing	2
lyudmila pinayeva-khvedosyuk, yekaterina kuryshko	URS	Canoeing	1
lyudmila rogachova	URS	Athletics	1
lyudmila shevtsova	URS	Athletics	1
mable fergerson, kathy hammond, cheryl toussaint, madeline manning-jackson	USA	Athletics	1
maciej freimut, wojciech krupiewski	POL	Canoeing	1
mack robinson	USA	Athletics	1
madeline manning-jackson	USA	Athletics	1
mads kruse andersen, morten j?rgensen, eskild ebbesen, thomas ebert	DEN	Rowing	1
mads rasumussen, rasmus hansen	DEN	Rowing	1
magdalena stoyanova georgieva	BUL	Rowing	1
mahe drysdale	NZL	Rowing	2
mahiedine mekhissibenabbad	FRA	Athletics	1
mahiedine mekhissi-benabbad	FRA	Athletics	1
maike nollen, carolin leonhardt, birgit fischer, katrin wagner	GER	Canoeing	1
mai nakamura	JPN	Swimming	1
maiola kalili, manuella kalili, george fissler, frank booth	USA	Swimming	1
makoto fukui, kunihiro iwasaki, toshio shoji, yukiaki okabe	JPN	Swimming	1
malcolm carmichael, charles wiggin	GBR	Rowing	1
malcolm spence	SAF	Athletics	1
malia metella	FRA	Swimming	1
mal whitfield	USA	Athletics	3
mal whitfield, arthur harnden, roy cochran, clifford bourland	USA	Athletics	1
mamo wolde	ETH	Athletics	3
manfred kinder, martin jellinghaus, gerhard hennige, helmar m?ller	FRG	Athletics	1
manfred klein, armin eichholz, thomas domian, ansgar wessling, eckhardt schultz, bahne rabe, wolfgang maennig, matthias mellinghaus, thomas m?llenkamp	FRG	Rowing	1
manuela lutze, manja kowalski, kerstin el qalqili-kowalski, meike evers	GER	Rowing	1
manuela lutze, meike evers, kerstin el qalqili-kowalski, kathrin boron	GER	Rowing	1
manuela stellmach	GDR	Swimming	1
manuel dos santos	BRA	Swimming	1
manuel plaza reyes	CHI	Athletics	1
marc bouissou, roger gautier, jacques guissart, pierre blondiaux	FRA	Rowing	1
marc burns, keston bledman, emmanuel callender, richard thompson	TTO	Athletics	1
marc detton, jean-pierre stock	FRA	Rowing	1
marcel hacker	GER	Rowing	1
marcel hansenne	FRA	Athletics	1
marcia jones	USA	Canoeing	1
marc weber, roland baar, detlef kirchhoff, mark kleinschmidt, wolfram huhn, frank richter, ulrich viefers, thorsten streppelhoff, peter thiede	GER	Rowing	1
marek dopierala, marek lbik	POL	Canoeing	1
marek lbik, marek dopierala	POL	Canoeing	1
marek witkowski, adam seroczynski, grzegorz kotowicz, dariusz bialkowski	POL	Canoeing	1
margaret bailes, barbara ferrell, wyomia tyus, mildrette netter	USA	Athletics	1
margarete adler, klara milch, josephine sticker, berta zahourek	AUT	Swimming	1
margaret edwards	GBR	Swimming	1
margaret hoelzer	USA	Swimming	2
margot marsman, marie-louise linssen-vaessen, irma heijting-schuhmacher, hanny termeulen	NED	Swimming	1
maria braun	NED	Swimming	2
maria cioncan	ROM	Athletics	1
maria gommers	NED	Athletics	1
maria mutola	MOZ	Athletics	2
mariana limbau, elena radu, raluca andreea ionita, sanda toma	ROM	Canoeing	1
marianne heemskerk	NED	Swimming	1
marianne kriel	RSA	Swimming	1
marianne limpert	CAN	Swimming	1
maria teresa ramirez	MEX	Swimming	1
maria vasco	ESP	Athletics	1
maricica puica	ROM	Athletics	1
marie baron	NED	Swimming	1
mariechen wehselau	USA	Swimming	1
marie delattre, anne-laure viard	FRA	Canoeing	1
marie-jos? p?rec	FRA	Athletics	3
marie-louise linssen-vaessen	NED	Swimming	1
marilyn black	AUS	Athletics	1
marilyn ramenofsky	USA	Swimming	1
marina koshevaya	URS	Swimming	2
marina yurchenya	URS	Swimming	1
marinus van den berge, jacob boot, jan de vries, henricus broos	NED	Athletics	1
mario lanzi	KIT	Athletics	1
marion shields	USA	Athletics	1
marise chamberlain	NZL	Athletics	1
marita koch	GDR	Athletics	1
mariya pinigina, olga nazarova, tatyana ledovskaya, olga bryzgina	URS	Athletics	1
mariya savinova	RUS	Athletics	1
marjorie jackson	AUS	Athletics	2
mark crear	USA	Athletics	2
mark de jonge	CAN	Canoeing	1
mark hunter, zac purchase	GBR	Rowing	1
mark kerry	AUS	Swimming	1
mark kerry, neil brooks, peter evans, mark tonelli	AUS	Swimming	1
mark lewis-francis, jason gardener, marlon devonish, darren campbell	GBR	Athletics	1
mark mccoy	CAN	Athletics	1
mark oldershaw	CAN	Canoeing	1
mark richardson, roger black, jamie baulch, iwan thomas	GBR	Athletics	1
mark rowland	GBR	Athletics	1
mark spitz	USA	Swimming	6
mark spitz, don schollander, john nelson, stephen rerych	USA	Swimming	1
mark stockwell	AUS	Swimming	1
mark tewksbury	CAN	Swimming	1
mark tewksbury, thomas ponting, victor davis, sandy goss	CAN	Swimming	1
markus gier, michael gier	SUI	Rowing	1
markus rogan	AUT	Swimming	2
markus ryffel	SUI	Athletics	1
mark warnecke	GER	Swimming	1
mark zabel, andreas ihle, bjorn bach, stefan ulm	GER	Canoeing	1
marleen veldhuis	NED	Swimming	1
marleen veldhuis, inge de bruijn, inge dekker, chantal groot, annabel kosten	NED	Swimming	1
marlene mathews	AUS	Athletics	2
marlies g?hr-oelsner	GDR	Athletics	1
marnie mcbean, diane o?grady, laryssa biesenthal, kathleen heddle	CAN	Rowing	1
marnie mcbean, kathleen heddle	CAN	Rowing	1
martha genenger	GER	Swimming	1
martha langbein, annie biechl, jutta heine, brunhilde hendrix	GER	Athletics	1
martha norelius	USA	Swimming	2
martha norelius, adelaide lambert, albina osipowich, eleanor garatti-saville	USA	Swimming	1
martha randall	USA	Swimming	1
martina grimaldi	ITA	Swimming	1
martina grunert, roswitha krause, uta schmuck, gabriele wetzko	GDR	Swimming	1
martina moravkova	SVK	Swimming	2
martin doktor	CZR	Canoeing	2
martin fromanack, charles aman, michael begley, frederick suerig, gustav voerg, frank dummerth, john freitag, louis helm	USA	Rowing	1
martin georgiev marinov	BUL	Canoeing	1
martin georgiev marinov, blagovest stoyanov	BUL	Canoeing	1
martin hawkins	USA	Athletics	1
martin hollstein, andreas ihle	GER	Canoeing	1
martin karl, rudolf eckstein, toni rom, willi menne	GER	Rowing	1
martin l?pez-zubero	ESP	Swimming	1
martin sinkovic, valent sinkovic, damir martin, david sain	CRO	Rowing	1
martin winter, frank dundr, karsten bunk, uwe heppner	GDR	Rowing	1
martti marttelin	FIN	Athletics	1
martyn woodroffe	GBR	Swimming	1
maryam yusuf jamal	BRN	Athletics	1
mary carew, evelyn furtsch, wilhelmina von bremen, annette rogers	USA	Athletics	1
maryna pautaran, volha khudzenka, nadzeya papok, iryna pamialova	BLR	Canoeing	1
mary onyali	NGR	Athletics	1
mary rand, janet simpson, daphne arden, dorothy hyman	GBR	Athletics	1
mary sears	USA	Swimming	1
mary t meagher	USA	Swimming	3
mary t meagher, nancy hogshead, tracey caulkins, theresa andrews	USA	Swimming	1
maryvonne dupureur	FRA	Athletics	1
mary washburn, elizabeth robinson, jessie cross, loretta mcneil	USA	Athletics	1
mary wayte	USA	Swimming	1
masahiro yoshimura	JPN	Swimming	1
masaji kiyokawa	JPN	Swimming	2
masami tanaka, mai nakamura, sumika minamoto, junko onishi	JPN	Swimming	1
masaru furukawa	JPN	Swimming	1
masonori yusa	JPN	Swimming	1
massimiliano rosolino	ITA	Swimming	3
massimiliano rosolino, matteo pelliciari, filippo magnini, emiliano brembilla, federico cappellazzo, simone cercato	ITA	Swimming	1
mate trojanovic, petar segvic, duje bonacic, velimir valenta	YUG	Rowing	1
matija ljubek	YUG	Canoeing	2
matija ljubek, mirko nisovic	YUG	Canoeing	1
matt biondi	USA	Swimming	5
matt biondi, chris cavanaugh, mike heath, ambrose gaines	USA	Swimming	1
matt biondi, troy dalbey, chris jacobs, thomas jager	USA	Swimming	1
matt grevers	USA	Swimming	1
matthew birir	KEN	Athletics	1
matthew grevers	USA	Swimming	1
matthew long, james tomkins	AUS	Rowing	1
matthew pinsent, steven redgrave	GBR	Rowing	1
matthew wells, stephen rowbotham	GBR	Rowing	1
matthew welsh	AUS	Swimming	2
matt targett, christian sprenger, hayden stoeckel, eamon sullivan, ashley delaney, andrew lauterstein, adam pine, brenton rickard	AUS	Swimming	1
matt vogel	USA	Swimming	1
maurice delvart, andr? devaux, gaston f?ry, g?o andr?	FRA	Athletics	1
maurice greene	USA	Athletics	2
maurice herriott	GBR	Athletics	1
maurizio damilano	ITA	Athletics	3
mavis freeman, bernice lapp, olive mckean, katherine rawls	USA	Swimming	1
maxey long	USA	Athletics	1
max hoff	GER	Canoeing	1
maxim opalev	RUS	Canoeing	3
max metzker	AUS	Swimming	1
max raub, herbert wiedermann	AUT	Canoeing	2
maxwell eley, robert morrison, terence sanders, james macnabb	GBR	Rowing	1
mayumi aoki	JPN	Swimming	1
mbulaeni mulaudzi	RSA	Athletics	1
mebrahtom keflezighi	USA	Athletics	1
megan jendrick, margaret hoelzer, elaine breeden, natalie coughlin, kara lynn joyce, christine magnuson, dara torres, rebecca soni	USA	Swimming	1
megan kalmoe, kara kohler, adrienne martelli, natalie dell	USA	Rowing	1
megan quann	USA	Swimming	1
megan still, kate slatter	AUS	Rowing	1
meinrad miltenberger, michael scheuer	GER	Canoeing	1
melaine walker	JAM	Athletics	1
melissa belote	USA	Swimming	2
melissa morrison	USA	Athletics	2
melvin patton	USA	Athletics	1
melvin sheppard	USA	Athletics	3
melvin sheppard, ted meredith, charles reidpath, edward lindberg	USA	Athletics	1
melvin stewart	USA	Swimming	1
meng guanliang, yang wenjun	CHN	Canoeing	1
merlene ottey-page	JAM	Athletics	7
merlene ottey-page, beverly mcdonald, tanya lawrence, veronica campbell	JAM	Athletics	1
merv wood	AUS	Rowing	2
meseret defar	ETH	Athletics	3
micah kogo	KEN	Athletics	1
michael bates	USA	Athletics	1
michael d?rsch, albert hedderich, raimund h?rmann, dieter wiedenmann	FRG	Rowing	1
michael gro?	FRG	Swimming	4
michael hart, chris baillieu	GBR	Rowing	1
michael holthaus	FRG	Swimming	1
michael jamieson	GBR	Swimming	1
michael johnson	USA	Athletics	3
michael johnson, steve lewis, quincy watts, andrew valmon	USA	Athletics	1
michael klim	AUS	Swimming	1
michael klim, toby haenen, steven dewick, scott miller, philip rogers	AUS	Swimming	1
michael kolganov	ISR	Canoeing	1
michael larrabee	USA	Athletics	1
michael larrabee, ulis williams, henry carr, ollan cassell	USA	Athletics	1
michael mathieu, ramon miller, avard moncur, christopher brown, andretti bain, andrae williams	BAH	Athletics	1
michael phelps	USA	Swimming	13
michael ryan	NZL	Athletics	1
michael shine	USA	Athletics	1
michael staines, calvin coffey	USA	Rowing	1
michael stamm	USA	Swimming	2
michael steinbach, stephan volkert, andr? willms, andreas hajek	GER	Rowing	1
michael tinsley	USA	Athletics	1
michael troy	USA	Swimming	1
michael wenden	AUS	Swimming	2
michael west	CAN	Swimming	1
michael west, thomas ponting, sandy goss, victor davis	CAN	Swimming	1
michal riszdorfer, richard riszdorfer, juraj baca, erik vlcek	SVK	Canoeing	1
michel andrieux, jean-christophe rolland	FRA	Rowing	1
michel chapuis, jean boudehen	FRA	Canoeing	1
michele pearson	AUS	Swimming	1
michel jazy	FRA	Athletics	1
michelle ford	AUS	Swimming	2
michelle guerette	USA	Rowing	1
michelle richardson	USA	Swimming	1
michelle smith	IRL	Swimming	4
michel th?ato	FRA	Athletics	1
mich?le chardonnet	FRA	Athletics	1
mieke jaapies	NED	Canoeing	1
miguel seijas, juan rodriguez	URU	Rowing	1
miguel white	PHI	Athletics	1
mihai zafiu, nicusor esanu, vasile diba, lon geanta	ROM	Canoeing	1
mihai zafiu, roman vartolomeu, aurel vernescu, atanase sciotnic	ROM	Canoeing	1
mih?ly hesz	HUN	Canoeing	2
mikael ?rn, bengt baron, per johansson, thomas lejdstr?m	SWE	Swimming	1
mike barrowman	USA	Swimming	1
mike boit	KEN	Athletics	1
mike bruner	USA	Swimming	1
mike burton	USA	Swimming	3
mike heath	USA	Swimming	1
mike lewis, liam parsons, jon beare, iain brambell	CAN	Rowing	1
mike marsh	USA	Athletics	1
mike mckay, james tomkins, andrew cooper, nicholas green	AUS	Rowing	1
mike mckay, stuart reside, stuart welch, geoff stewart, james stewart, steve stewart, michael toon, stefan szczurowski, bo hanson	AUS	Rowing	1
mike mcleod	GBR	Athletics	1
mike musyoki	KEN	Athletics	1
mike o'brien	USA	Swimming	1
mikhail kaaleste, anatoly demitkov	URS	Canoeing	1
mikhail shchennikov	RUS	Athletics	1
mikhail slivinsky	URS	Canoeing	2
mikhail zamotin, naum prokupets	URS	Canoeing	1
miki nakao	JPN	Swimming	1
milan janic	YUG	Canoeing	1
millard hampton	USA	Athletics	1
millon wolde	ETH	Athletics	1
milorad cavic	SRB	Swimming	1
milosz bernatajtys, bartlomiej pawelczak, lukasz pawlowski, pawel randa	POL	Rowing	1
mina wylie	ANZ	Swimming	1
mireia belmonte garcia	ESP	Swimming	2
mirka knapkova	CZE	Rowing	1
mirko nisovic, matija ljubek	YUG	Canoeing	1
mirna jukic	AUT	Swimming	1
miroslav kon?cek, bohumil janousek, jan jindra, jir? lund?k, stanislav lusk, v?clav pavkovic, ludek pojezny, josef ventus, jan sv?da	CZE	Rowing	1
miruts yifter	ETH	Athletics	3
missy franklin	USA	Swimming	2
missy schwen, karen kraft	USA	Rowing	2
misty hyman	USA	Swimming	1
mitchell ivey	USA	Swimming	2
mitica pricop, florin popescu	ROM	Canoeing	1
mitzi kremer, dara torres, laura walker, mary wayte	USA	Swimming	1
mizuki noguchi	JPN	Athletics	1
mo farah	GBR	Athletics	2
mohamed gammoudi	TUN	Athletics	4
mohamed sulaiman	QAT	Athletics	1
mohammed kedir	ETH	Athletics	1
moira abernethy, jeanette myburgh, nathalie myburgh, susan roberts	SAF	Swimming	1
monika zehrt	GDR	Athletics	1
morgan taylor	USA	Athletics	3
morris kirksey	USA	Athletics	1
morris kirksey, loren murchison, charles paddock, jackson scholz	USA	Athletics	1
moses kiptanui	KEN	Athletics	1
murray halberg	NZL	Athletics	1
murray riley, merv wood	AUS	Rowing	1
murray rose	AUS	Swimming	4
murray rose, kevin o'halloran, jon henricks, john devitt	AUS	Swimming	1
myrtle cook, florence bell, fanny rosenfeld, ethel smith	CAN	Athletics	1
nadezhda ilyina, inta klimovica, lyudmila aksenova, natalya sokolova	URS	Athletics	1
nadezhda khnykina	URS	Athletics	1
nadezhda olizarenko	URS	Athletics	2
naftali temu	KEN	Athletics	2
naman keita	FRA	Athletics	1
nancy garapick	CAN	Swimming	2
nancy hogshead	USA	Swimming	2
nancy lagat	KEN	Athletics	1
nancy ramey	USA	Swimming	1
naoko takahashi	JPN	Athletics	1
narcisco su?rez, enrique miguez	ESP	Canoeing	1
natalia antyukh	RUS	Athletics	1
natalie coughlin	USA	Swimming	5
natalie steward	GBR	Swimming	2
nataliya tobias	UKR	Athletics	1
natallia helakh, yuliya bichyk	BLR	Rowing	1
natalya antyukh	RUS	Athletics	1
natalya antyukh, tatiana firova, yulia gushchina, antonina krivoshapka	RUS	Athletics	1
natalya bochina	URS	Athletics	1
natalya lavrinenko, tamara davydenko, marina znak, natalya volchek, natalya stasyuk, valentina skrabatun, yelena mikulich, aleksandra pankina, yaroslava pavlovich	BLR	Rowing	1
natalya lebedeva	URS	Athletics	1
natalya pechenkina	URS	Athletics	1
natalya ustinova, tatyana savelyeva, svetlana babalina, tatyana devyatova	URS	Swimming	1
natasa janic	HUN	Canoeing	1
natasa janics	HUN	Canoeing	1
natasa janics, katalin kovacs	HUN	Canoeing	2
nate cartmell	USA	Athletics	3
nathan adrian	USA	Swimming	1
nathan baggaley	AUS	Canoeing	1
nathan cohen, joseph sullivan	NZL	Rowing	1
nathan deakes	AUS	Athletics	1
natsumi hoshi	JPN	Swimming	1
nawal el moutawakel	MAR	Athletics	1
neil cochran	GBR	Swimming	1
neil walker, gary hall jr., tommy hannan, jason lezak, lenny krayzelburg, ian crocker, ed moses	USA	Swimming	1
neisser bent	CUB	Swimming	1
nelly van vliet	NED	Swimming	1
nelson diebel	USA	Swimming	1
neville hayes	AUS	Swimming	1
neville hayes, terry gathercole, geoffrey shipton, david theile	AUS	Swimming	1
nicholas willis	NZL	Athletics	1
nick gillingham	GBR	Swimming	2
nick thoman	USA	Swimming	1
nicole haislett	USA	Swimming	1
nicole stevenson	AUS	Swimming	1
nico rienks, ronald florijn	NED	Rowing	1
nida senff	NED	Swimming	1
niels henriksen, victor feddersen, eskild ebbesen, thomas poulsen	DEN	Rowing	1
nigel barker	AUS	Athletics	2
nijel amos	BOT	Athletics	1
nijole sabaite	URS	Athletics	1
nikki payne, lynley hannen	NZL	Rowing	1
nikolaos skiathitis, vasileios polymeros	GRE	Rowing	1
nikolay bukhalov	BUL	Canoeing	3
nikolay chernetsky, mikhail linge, viktor markin, remigijus valiulis	URS	Athletics	1
nikolay dovgan, valery kleshnyov, yevgeny barbakov, yury shapochka	URS	Rowing	1
nikolay gorbachov, viktor kratasyuk	URS	Canoeing	1
nikolay kirov	URS	Athletics	1
nikolay kolesnikov, valery borzov, aleksandr aksinin, juris silovs	URS	Athletics	1
nikolay kuznetsov, raul arnemann, valery dolinin, anushavan gassan-dzhalilov	URS	Rowing	1
nikolay pankin	URS	Swimming	1
nikolay pimenov, yury pimenov	URS	Rowing	1
nikolay sidorov, vladimir muravyov, andrey prokofyev, aleksandr aksinin	URS	Athletics	1
nikolay smaga	URS	Athletics	1
nikolay sokolov	URS	Athletics	1
nikolina shtereva	BUL	Athletics	1
niksa skelin, sinisa skelin	CRO	Rowing	1
nils bj?rkl?f, ture axelsson	FIN	Canoeing	1
nils engdahl	SWE	Athletics	1
nils fjeldheim, eirik larsen	NOR	Canoeing	1
nils schumann	GER	Athletics	1
nimrod greenwood, david anderson, mervyn finlay, philip cayzer, ernest chapman, thomas chessel, edward pain, robert tinning, geoffrey willamson	AUS	Rowing	1
nina savina	URS	Canoeing	1
nina trofimova-gopova, galina alekseyeva-kreft	URS	Canoeing	1
nina zhivanevskaya	ESP	Swimming	1
nina zhivanevskaya, olga kirichenko, elena choubina, yelena rudkovskaya, natalya meshcheryakova	URS	Swimming	1
nixon kiprotich	KEN	Athletics	1
n?ndor d?ni	HUN	Athletics	1
noah ngeny	KEN	Athletics	1
noboru terada	JPN	Swimming	1
nobuharu asahara, shingo suetsugu, shinji takahira, naoki tsukahara	JAP	Athletics	1
nobuo arai, tokuhei sada, hiroshi yoneyama, katsuo takaishi	JPN	Swimming	1
nobutaka taguchi	JPN	Swimming	2
noe hernandez	MEX	Athletics	1
noel freeman	AUS	Athletics	1
noemi ildik? lung	ROM	Swimming	2
no?l de mille, ned pratt	CAN	Rowing	1
norbert ke?lau, guido grabow, volker grabow, j?rg puttlitz	FRG	Rowing	1
norberto t?llez, l?zaro mart?nez, roberto hern?ndez, h?ctor herrera	CUB	Athletics	1
norbert r?zsa	HUN	Swimming	3
norman hallows	GBR	Athletics	1
norman pritchard	BIN	Athletics	1
norman ross	USA	Swimming	2
norman taber	USA	Athletics	1
norm read	NZL	Athletics	1
noureddine morceli	ALG	Athletics	1
nouria merah-benida	ALG	Athletics	1
nouzha bidouane	MAR	Athletics	1
novella calligaris	ITA	Swimming	3
obadele thompson	BAR	Athletics	1
olaf heukrodt	GDR	Canoeing	2
olaf heukrodt	GER	Canoeing	1
olaf heukrodt, uwe madeja	GDR	Canoeing	1
olaf tufte	NOR	Rowing	2
olaf tufte, fredrik raaen bekken	NOR	Rowing	1
olapade adeniken, davidson ezinwa, chidi imoh, oluyemi kayode	NGR	Athletics	1
oleg gorobiy, anatoliy tishchenko, sergey verlin, georgy tsybulnikov	RUS	Canoeing	1
oleg tyurin, boris dubrovsky	URS	Rowing	1
olena krasovska	UKR	Athletics	1
olesya zykina, natalia antyukh, natalya nazarova, olesya krasnomovets	RUS	Athletics	1
olga bogoslovskaya, galina malchugina, irina privalova, marina trandenkova	URS	Athletics	1
olga bondarenko	URS	Athletics	1
olga bryzgina	URS	Athletics	2
olga homeghi, herta anitas, rodica arba, mihaela armasescu, adriana bazon-chelariu, ekaterina oancia, veronica necula	ROM	Rowing	1
olga kaniskina	RUS	Athletics	2
olga nazarova	URS	Athletics	1
olga shishigina	KAZ	Athletics	1
olimpiada ivanova	RUS	Athletics	1
oliver kegel, thomas reineck, mario von appen, andr? wohllebe	GER	Canoeing	1
ollie matson	USA	Athletics	1
ollie matson, gene cole, mal whitfield, charles moore	USA	Athletics	1
ondrej synek	CZE	Rowing	1
ondrej synek	CZR	Rowing	1
ophelie-cyrielle etienne, camille muffat, coralie balmy, charlotte bonnet	FRA	Swimming	1
oscar taelman, r?my orban, rodolphe poma, georges mijs, marcel morimont, alfred vanlandeghem, polydore veirman, fran?ois vergucht, oscar charles de somville, john burn, oswald carver, gordon balfour, richard boyle, douglas kertland, harold kitching, walter lewis, henry goldsmith, frank jerwood, becher robert gale, julius thomson, edward williams, george wright, charles riddy, irvine robertson, eric powell, geoffrey taylor, douglas stuart	GBR	Rowing	1
oszk?r frey, tam?s buday	HUN	Canoeing	1
otis davis	USA	Athletics	1
otis harris jr	USA	Athletics	1
otto fahr	DEU	Swimming	1
otto herschmann	AUT	Swimming	1
ottorino quaglierini, cesare milani, dante secchi, enrico garzelli, oreste grossi, mario checcacci, guglielmo del bimbo, dino barsotti, enzo bartolini	KIT	Rowing	1
otto scheff	AUT	Swimming	3
otylia jedrzejczak	POL	Swimming	3
oussama mellouli	TUN	Swimming	3
ove andersen	FIN	Athletics	1
paavo nurmi	FIN	Athletics	7
pablo morales	USA	Swimming	3
pamela jelimo	KEN	Athletics	1
pamela kruse	USA	Swimming	1
pamela rai, michelle macpherson, anne ottenbrite, reema abdo	CAN	Swimming	1
pang jiaying	CHN	Swimming	1
pang jiaying, zhu qianwei, tan miao, tang jingzhi, yang yu	CHN	Swimming	1
paola cacchi-pigni	ITA	Athletics	1
park taehwan	KOR	Swimming	2
partridge, foad, ransley, egington, sbihi, searle, langridge, louloudis, hill	GBR	Rowing	1
pascal touron, frederic dufour	FRA	Rowing	1
pascal touron, thibaud chapelle	FRA	Rowing	1
pat costello, jim gardiner	USA	Rowing	1
patricia girard-l?no	FRA	Athletics	1
patricia jones, viola myers, nancy mackay, diane foster	CAN	Athletics	1
patrick flynn	USA	Athletics	1
patrick k?hl	GDR	Swimming	1
patrick lefoulon, bernard bregeon	FRA	Canoeing	1
patrick sang	KEN	Athletics	1
paula ivan	ROM	Athletics	1
paul bitok	KEN	Athletics	2
paul bontemps	FRA	Athletics	1
paul costello, charles mcilvane	USA	Rowing	1
paul drayton	USA	Athletics	1
paul ereng	KEN	Athletics	1
paul-heinz wellmann	FRG	Athletics	1
paul hoekstra, anton geurts	NED	Canoeing	1
paul howe, neil cochran, paul easter, andrew astbury	GBR	Swimming	1
pauline davis-thompson	BAH	Athletics	1
pauline konga	KEN	Athletics	1
paul kellner	DEU	Swimming	1
paul kingsman	NZL	Swimming	1
paul kipsiele koech	KEN	Athletics	1
paul macdonald	NZL	Canoeing	1
paul macdonald, ian ferguson	NZL	Canoeing	1
paul martin	SUI	Athletics	1
paul nihill	GBR	Athletics	1
paul palmer	GBR	Swimming	1
paul pilgrim	USA	Athletics	2
paul radmilovic, rob derbyshire, william foster, henry taylor	GBR	Swimming	1
paul tergat	KEN	Athletics	2
paul wolf, ralph flanagan, john macionis, jack medica	USA	Swimming	1
paul wyatt	USA	Swimming	2
pavel khnykin, vladislav kulikov, vasily ivanov, vladimir selkov, vladimir pyshnenko, aleksandr popov, dmitry volkov	URS	Swimming	1
pavel khnykin, yury bashkatov, gennady prigoda, vladimir pyshnenko, aleksandr popov, veniamin tayanovich	URS	Swimming	1
pekka vasala	FIN	Athletics	1
penny heyns	RSA	Swimming	3
pepijn aardewijn, maarten van der linden	NED	Rowing	1
percy beard	USA	Athletics	1
percy hodge	GBR	Athletics	1
percy williams	CAN	Athletics	2
per holmertz	SWE	Swimming	1
per johansson	SWE	Swimming	2
per olof ?strand	SWE	Swimming	1
perry mcgillivray, norman ross, pua kealoha, duke kahanamoku	USA	Swimming	1
pertti karppinen	FIN	Rowing	3
petar merkov	BUL	Canoeing	2
petar petrov	BUL	Athletics	1
peter antonie, stephen hawkins	AUS	Rowing	1
peter elliott	GBR	Athletics	1
peter evans	AUS	Swimming	2
peter evans, glenn buchanan, mark kerry, mark stockwell	AUS	Swimming	1
peter frenkel	GDR	Athletics	2
peter higgins, derek johnson, john salisbury, michael wheeler	GBR	Athletics	1
peter jackson, john sturrock, thomas bristow, alan barrett	GBR	Rowing	1
peter kersten	GDR	Rowing	1
peter koech	KEN	Athletics	1
peter kretschmer, kurt kuschela	GER	Canoeing	1
peter michael kolbe	FRG	Rowing	3
peter nocke	FRG	Swimming	1
peter nocke, walter kusch, michael kraus, klaus steinbach	FRG	Swimming	1
peter norman	AUS	Athletics	1
peter olsen, harry larsen	DEN	Rowing	1
peter radford	GBR	Athletics	1
peter raymond, lawrence terry, timothy mickelson, john livingston, michael livingston, eugene clapp, fritz hobbs, william hobbs, paul hoffman	USA	Rowing	1
peter rocca	USA	Swimming	2
peter rono	KEN	Athletics	1
peter snell	NZL	Athletics	3
peter taylor, storm uru	NZL	Rowing	1
peter vanderkaay	USA	Swimming	2
peter vanderkaay, erik vendt, david walters, ricky berens, michael phelps, ryan lochte, klete keller	USA	Swimming	1
peter vanderkaay, michael phelps, ryan lochte, scott goldblatt, dan ketchum, klete keller	USA	Swimming	1
petra m?ller	GDR	Athletics	1
petra priemer	GDR	Swimming	1
petra riedel	GDR	Swimming	1
petra schneider	GDR	Swimming	2
petra th?mer	GDR	Swimming	2
petra van staveren	NED	Swimming	1
petra zindler	FRG	Swimming	1
petria thomas	AUS	Swimming	4
petru iosub, valer toma	ROM	Rowing	1
philip edwards	CAN	Athletics	3
philip johnson, laurence hough	USA	Rowing	1
philip noel-baker	GBR	Athletics	1
philippe boccara, pascal boucherit, fran?ois barouh, didier vavasseur	FRA	Canoeing	1
philip rogers	AUS	Swimming	1
philip verdon, george fairbairn, willy d?skow, norwey jackes, f b toms, martin stahnke	DEU	Rowing	1
phillip hubble	GBR	Swimming	1
phyllis harding	GBR	Swimming	1
pier angelo conti manzini, abramo albini, tullio baraglia, renato bosatta	ITA	Rowing	1
piero poli, davide tizzano, agostino abbagnale, gianluca farina	ITA	Rowing	1
pierre-jean peltier, julien bahain, c?dric berrest, jonathan coeffic	FRA	Rowing	1
pieter van den hoogenband	NED	Swimming	5
pieter van den hoogenband, mark veens, mitja zastrow, klaas-erik zwering, johan kenkhuis	NED	Swimming	1
pietro ivanov, latino galasso, giuseppe grivelli, vittorio gliubich, antonio cattalinich, francesco cattalinich, simeone cattalinich, carlo toniatti, bruno sorich	KIT	Rowing	1
pietro mennea	ITA	Athletics	2
pino dordoni	ITA	Athletics	1
piotr markiewicz	POL	Canoeing	1
pokey watson	USA	Swimming	1
polydore veirman	BEL	Rowing	1
pontus hanson	SWE	Swimming	1
p?r arvidsson	SWE	Swimming	1
priscah jeptoo	KEN	Athletics	1
priscilla lopesschliep	CAN	Athletics	1
pua kealoha	USA	Swimming	1
puck oversloot, corrie ladd?, willie den ouden, marie vierdag	NED	Swimming	1
pyotr bolotnikov	URS	Athletics	1
pyotr pochenchuk	URS	Athletics	1
quincy watts	USA	Athletics	1
rachael taylor, kate slatter	AUS	Rowing	1
rachid el basir	MAR	Athletics	1
raelene boyle	AUS	Athletics	3
rafael vidal	VEN	Swimming	1
rafal piszcz, wladyslaw szuszkiewicz	POL	Canoeing	1
rafal szukala	POL	Swimming	1
ragnhild hveger	DEN	Swimming	1
ralf l?bke, norbert dobeleit, edgar itt, j?rg vaihinger	FRG	Athletics	1
ra?l gonz?lez	MEX	Athletics	2
ralph craig	USA	Athletics	2
ralph doubell	AUS	Athletics	1
ralph hill	USA	Athletics	1
ralph hutton	CAN	Swimming	1
ralph mann	USA	Athletics	1
ralph metcalfe	USA	Athletics	3
raman piatrushenka, vadzim makhneu	BLR	Canoeing	2
ramona portwich, anke nothnagel-von seck	GER	Canoeing	1
ramon de clemente, donovan cech	RSA	Rowing	1
ramon miller, chris brown, michael mathieu, demetrius pinder	BAH	Athletics	1
ran laurie, jack wilson	GBR	Rowing	1
ranomi kromowidjojo	NED	Swimming	2
raoul rodriguez, thomas bohrer, richard kennelly, david krmpotich	USA	Rowing	1
rashid ramzi	BRN	Athletics	1
rasmus quist, mads reinholdt rasmussen	DEN	Rowing	1
ray armstead, alonzo babers, antonio mckay, sunder nix	USA	Athletics	1
ray kegeris	USA	Swimming	1
raymond barbuti	USA	Athletics	1
ray stewart, don quarrie, al lawrence, greg meghoo	JAM	Athletics	1
razvan florea	ROM	Swimming	1
r?diger helm	GDR	Canoeing	3
r?diger helm, bernd duvigneau, bernd olbricht, harald marg	GDR	Canoeing	1
r?diger helm, bernd olbricht	GDR	Canoeing	1
r?diger reiche, karl-heinz bu?ert, wolfgang g?ldenpfennig, michael wolfgramm	GDR	Rowing	1
rebecca adlington	GBR	Swimming	4
rebecca sattin, kerry hore, dana faletic, amber bradley	AUS	Rowing	1
rebecca soni	USA	Swimming	4
reggie walker	SAF	Athletics	1
reiko nakamura	JPN	Swimming	2
reinaldo gorno	ARG	Athletics	1
reizo koike	JPN	Swimming	2
renate breuer	FRG	Canoeing	1
renate stecher	GDR	Athletics	4
renate stecher, b?rbel struppert, christina heinich, evelyn kaufer	GDR	Athletics	1
ren? tirard, ren? lorain, ren? mourlon, emile ali-khan	FRA	Athletics	1
reuben kosgei	KEN	Athletics	1
rex cawley	USA	Athletics	1
rhadi ben abdesselam	MAR	Athletics	1
ricardo prado	BRA	Swimming	1
rica reinisch	GDR	Swimming	2
richard beesly, edward bevan, john lander, michael warriner	GBR	Rowing	1
richard burnell, bert bushnell	GBR	Rowing	1
richard chambers, robert williams, chris bartley, peter chambers	GBR	Rowing	1
richard chelimo	KEN	Athletics	1
richard colella	USA	Swimming	1
richard corts, georg lammers, helmuth k?rnig, hubert houben	GER	Athletics	1
richard howard	USA	Athletics	1
richard kipkemboi	KEN	Athletics	1
richard novy, jan mrv?k, miroslav kon?cek, jir? lund?k, bohumil janousek, ludek pojezny, julius tocek, petr cerm?k, josef ventus	CZE	Rowing	1
richard roth	USA	Swimming	1
richard thompson	TRI	Athletics	1
richard thompson, aaron armstrong, marc burns, emmanuel callender, keston bledman	TRI	Athletics	1
richard weinberger	CAN	Swimming	1
richard wohlhuter	USA	Athletics	1
rick carey	USA	Swimming	2
rick carey, ambrose gaines, steve lundquist, pablo morales	USA	Swimming	1
rick mitchell	AUS	Athletics	1
rie mastenbroek	NED	Swimming	3
rita k?b?n	HUN	Canoeing	2
rita k?b?n, erika m?sz?ros, ?va d?nusz, kinga czig?ny	HUN	Canoeing	1
rita k?b?n, erika m?sz?ros, ?va rakusz, erika g?czi	HUN	Canoeing	1
rita k?hne, helga seidler, dagmar k?sling, monika zehrt	GDR	Athletics	1
rita wilden	FRG	Athletics	1
roberta brunet	ITA	Athletics	1
robertas zulpa	URS	Swimming	1
robert baetens, michel knuysen	BEL	Rowing	1
robert bennett	USA	Swimming	2
robert boutigny	FRA	Canoeing	1
robert chef d'h?tel, jean kerebel, jacques lunis, fran?ois schewetta	FRA	Athletics	1
robert cloughen	USA	Athletics	1
robert cowell	USA	Swimming	1
robert cusack, yury gromak, gregory rogers, michael wenden, robert windle	AUS	Swimming	1
robert hackett	USA	Swimming	1
robert kerr	CAN	Athletics	2
robert kiesel, hector dyer, emmett toppino, frank wykoff	USA	Athletics	1
robert korzeniowski	POL	Athletics	4
robert mcgregor	GBR	Swimming	1
robert mcmillen	USA	Athletics	1
robert mills	CAN	Rowing	1
robert nisbet, terence o'brien	GBR	Rowing	1
roberto tozzi, pietro mennea, stefano malinverni, mauro zuliani	ITA	Athletics	1
robert perew, stuart griffing, frederick kingsbury, gregory gates	USA	Rowing	1
robert richards, anthony edwards, simon burgess, darren balmforth	AUS	Rowing	1
robert scott, david weightman	AUS	Rowing	1
robert skelton	USA	Swimming	1
robert sycz, tomasz kucharski	POL	Rowing	2
robert taylor	USA	Athletics	1
robert wilson, philip kueber, david helliwell, william mckerlich, richard mcclure, douglas mcdonald, lawrence west, carlton ogawa, donald pretty	CAN	Rowing	1
robert windle	AUS	Swimming	1
robert windle, john ryan, peter doak, david dickson	AUS	Swimming	1
robert woodhouse	AUS	Swimming	1
robert young, harold cagle, al fitch, edward o'brien	USA	Athletics	1
robin backhouse	USA	Swimming	1
robson da silva	BRA	Athletics	1
rob waddell	NZL	Rowing	1
robyn thorn, dawn fraser, lynette bell, janice murphy	AUS	Swimming	1
rochelle stevens, jearl miles, maicel malone, kim graham	USA	Athletics	1
rodica arba, olga homeghi	ROM	Rowing	1
rodney dixon	NZL	Athletics	1
rodney milburn	USA	Athletics	1
rodolfo falcon	CUB	Swimming	1
rod strachan	USA	Swimming	1
roelof luynenburg, ruud stokvis	NED	Rowing	1
roger black	GBR	Athletics	1
roger kingdom	USA	Athletics	2
roger moens	BEL	Athletics	1
roger pyttel	GDR	Swimming	2
roland kokeny, rudolf dombi	HUN	Canoeing	1
roland matthes	GDR	Swimming	5
roland matthes, lutz unger, klaus katzur, hartmut fl?ckner	GDR	Swimming	1
roland schoeman	RSA	Swimming	2
roland wieser	GDR	Athletics	1
rolf larcher, ernst h?rlimann	SUI	Rowing	1
rolf peterson	SWE	Canoeing	2
roline repelaer van driel, sarah siegelaar, marlies smulders, helen tanger, annemarieke van rumpt, annemiek de haan, femke dekker, nienke kingma	NED	Rowing	1
roman sloudnov	RUS	Swimming	1
romeo bertini	KIT	Athletics	1
romolo catasta	ITA	Rowing	1
ronald mills	USA	Swimming	1
ronald rauhe, tim wiesk?tter	GER	Canoeing	2
ronald weigel	GDR	Athletics	2
ronald weigel	GER	Athletics	1
ron clarke	AUS	Athletics	1
ron delany	IRL	Athletics	1
ron freeman	USA	Athletics	1
ronnie-ray smith, melvin pender, jim hines, charlie greene	USA	Athletics	1
rosa mota	POR	Athletics	2
roscoe lockwood, edward marsh, john geiger, john exley, james juvenal, edward hedley, louis abell, william carr, harry debaecke	USA	Rowing	1
rosemarie gabriel	GDR	Swimming	1
rosemarie whyte, shericka williams, novlene williams-mills, christine day	JAM	Athletics	1
rossano galtarossa, luca agamennoni, simone venier, simone raineri	ITA	Rowing	1
ross wales	USA	Swimming	1
roswitha beier	GDR	Swimming	1
roswitha beier, kornelia ender, christine herbst, renate vogel	GDR	Swimming	1
roswitha esser, annemarie zimmermann	FRG	Canoeing	1
roswitha esser, annemarie zimmermann	GER	Canoeing	1
roxana maracineanu	FRA	Swimming	1
roy cochran	USA	Athletics	1
roy saari	USA	Swimming	1
?rp?d lengyel, ?d?n gr?f, ferenc csik, oszk?r abay nemes	HUN	Swimming	1
rudi harbig, helmut hamann, harry voigt, friedrich von st?lpnagel	GER	Athletics	1
rudolf reichelt, kurt runge, hans matthiae, max vetter, otto liebing, max br?ske, fritz bartholom?, willi bartholom?, werner dehn	DEU	Rowing	1
ruggero maregatti, giuseppe castelli, edgardo toetti, gabriele salviati	KIT	Athletics	1
rui silva	POR	Athletics	1
rumyana neykova	BUL	Rowing	3
rune larsson	SWE	Athletics	1
rupert weinstabl, karl proisl	AUT	Canoeing	1
rusty wailes, robert morey, charles grimes, william becklean, donald beer, caldwell esselstyn, thomas charlton, john cooke, david wight	USA	Rowing	1
ruta meilutyte	LTU	Swimming	1
ryan cochrane	CAN	Swimming	2
ryan lochte	USA	Swimming	7
ryan lochte, michael phelps, nathan adrian, cullen jones	USA	Swimming	1
ryan lochte, michael phelps, ricky berens, conor dwyer	USA	Swimming	1
ryan mitchell, adam pine, ian thorpe, michael klim, regan harrison, geoff huegill, josh watson, matthew welsh	AUS	Swimming	1
ryosuke irie	JPN	Swimming	2
ryo tateishi	JPN	Swimming	1
sabine steinbach	GDR	Swimming	1
sa?d aouita	MAR	Athletics	2
sadik mujkic, bojan preseren	YUG	Rowing	1
salah hissou	MAR	Athletics	1
sally gunnell	GBR	Athletics	1
sally jepkosgei kipyego	KEN	Athletics	1
sally mclellan	AUS	Athletics	1
sally pearson	AUS	Athletics	1
salvatore antibo	ITA	Athletics	1
salvatore morale	ITA	Athletics	1
samantha riley	AUS	Swimming	2
sam graddy	USA	Athletics	1
sam graddy, ron brown, carl lewis, calvin smith	USA	Athletics	1
samson kitur	KEN	Athletics	1
samuel barathay, frederic kowal	FRA	Rowing	1
samuel ferris	GBR	Athletics	1
samuel kahanamoku	USA	Swimming	1
samuel matete	ZAM	Athletics	1
samuel wansiru	KEN	Athletics	1
sandie richards, michelle burgher, nadia davy, novlene williams	JAM	Athletics	1
sandra farmer-patrick	USA	Athletics	1
sandra morgan, faith leech, dawn fraser, lorraine crapp	AUS	Swimming	1
sandra neilson	USA	Swimming	1
sandra neilson, melissa belote, deena deardurff, catherine carr	USA	Swimming	1
sandra v?lker	GER	Swimming	2
sandro bellucci	ITA	Athletics	1
sanna sten, minna nieminen	FIN	Rowing	1
sanya richards	USA	Athletics	1
sanya richards, monique henderson, monique hennagan, deedee trotter	USA	Athletics	1
sanya richards, monique henderson, natasha hastings, allyson felix, mary wineberg	USA	Athletics	1
sanya richards-ross	USA	Athletics	1
sarah hardcastle	GBR	Swimming	2
sarah outhwaite, kate hornsey	AUS	Rowing	1
sarah p?we, antje buschschulte, franziska van almsick	GER	Swimming	1
sarah winckless, elise laverick	GBR	Rowing	1
sara isakovic	SLO	Swimming	1
sara nordenstam	NOR	Swimming	1
saso mirjanic, sadik mujkic, milan jansa, janez klemencic	SLO	Rowing	1
satoko tanaka	JPN	Swimming	1
satomi suzuki	JPN	Swimming	2
satymkul dzhumanazarov	URS	Athletics	1
saul craviotto rivero	ESP	Canoeing	1
schuyler enck	USA	Athletics	1
scott frandsen, david calder	CAN	Rowing	1
scott gault, charles cole, glenn ochal, henrik rummel	USA	Rowing	1
scott goldblatt, nate dusing, chad carvin, josh davis, klete keller, jamie rauch	USA	Swimming	1
scott goodman	AUS	Swimming	1
scott miller	AUS	Swimming	1
sebastian brendel	GER	Canoeing	1
sebastian coe	GBR	Athletics	4
sebastien vieilledent, adrien hardy	FRA	Rowing	1
seleshi sehen	ETH	Athletics	1
semyon belitz-geyman, vladimir bure, georgi kulikov, leonid ilyichov	URS	Swimming	1
semyon rzhishchin	URS	Athletics	1
sergeij fedorovtsev, igor kravtsov, nikolai spinev, alexeij svirin	RUS	Rowing	1
sergey chukhray, aleksandr degtyarev, yury filatov, vladimir morozov	URS	Canoeing	1
sergey chukhray, vladimir parfenovich	URS	Canoeing	1
sergey fesenko	URS	Swimming	2
sergey kirdyapkin	RUS	Athletics	1
sergey koplyakov	URS	Swimming	1
sergey nagorny, vladimir romanovsky	URS	Canoeing	2
sergey petrenko, aleksandr vinogradov	URS	Canoeing	1
sergey postrekhin	URS	Canoeing	2
sergey ulegin, alexander kostoglod	RUS	Canoeing	1
serghei covaliov, ivan patzaichin	ROM	Canoeing	1
sergij grin, sergij bilushchenko, oleg lykov, leonid shaposhnikov	UKR	Rowing	1
sergio l?pez	ESP	Swimming	1
sevatheda fynes, debbie ferguson, pauline davis-thompson, chandra sturrup	BAH	Athletics	1
seymour cromwell, james storm	USA	Rowing	1
shalane flanagan	USA	Athletics	1
shane gould	AUS	Swimming	5
shannon smith	CAN	Swimming	1
sharon finneran	USA	Swimming	1
sharon stouder	USA	Swimming	2
sharon stouder, cynthia goyette, kathleen ellis, cathy ferguson	USA	Swimming	1
sharon wichman	USA	Swimming	2
sharron davies	GBR	Swimming	1
shawn crawford	USA	Athletics	2
shawn crawford, justin gatlin, maurice greene, coby miller	USA	Athletics	1
sheena tosta	USA	Athletics	1
sheila echols, florence griffith-joyner, alice brown, evelyn ashford	USA	Athletics	1
shelley mann	USA	Swimming	1
shelley mann, nancy simons, sylvia ruuska, joan rosazza	USA	Swimming	1
shelly-ann fraser	JAM	Athletics	1
shelly-ann fraser-pryce	JAM	Athletics	2
shenjie qieyang	CHN	Athletics	1
shereefa lloyd, shericka williams, novlene williams, rosemarie whyte, bobby-gaye wilkins	JAM	Athletics	1
shericka williams	JAM	Athletics	1
sherone simpson	JAM	Athletics	1
sherri howard, valerie brisco-hooks, chandra cheeseborough	USA	Athletics	1
shigeo arai	JPN	Swimming	1
shigeo arai, shigeo sugiura, masahari taguchi, masonori yusa	JPN	Swimming	1
shirley babashoff	USA	Swimming	5
shirley babashoff, jane barkman, jennifer kemp, sandra neilson	USA	Swimming	1
shirley strickland	AUS	Athletics	3
shirley strickland, fleur mellor, betty cuthbert, norma croker	AUS	Athletics	1
shirley strong	GBR	Athletics	1
shiro hashizume	JPN	Swimming	1
shiwen ye	CHN	Swimming	2
shouying zhou, xiuhua zhou, xianghua zhang, yali zhang, xiao yang, yadong hu, yaqin han, yanwen he, ronghua li	CHN	Rowing	1
shozo makino	JPN	Swimming	2
shumpei uto	JPN	Swimming	2
sidney atkinson	SAF	Athletics	2
sidney swann, philip fleming, henry wells, leslie wormwald, stanley garton, angus gillan, ewart horsfall, alister kirby, edgar burgess	GBR	Rowing	1
sigrun wodars	GDR	Athletics	1
sileshi sihine	ETH	Athletics	1
silke h?rner	GDR	Swimming	2
silken laumann	CAN	Rowing	2
silvia chiv?s	CUB	Athletics	1
silvia chiv?s, marlene elejarde, carmen vald?s, fulgencia romay	CUB	Athletics	1
silvia poll	CRC	Swimming	1
silvio leonard	CUB	Athletics	1
simone osygus, bettina ustrowski, daniela brendel, jana d?rries, dagmar hase, daniela hunger, franziska van almsick	GER	Swimming	1
simone osygus, manuela stellmach, kerstin kielga?, annette hadding, daniela hunger, franziska van almsick	GER	Swimming	1
simone raineri, alessio sartori, agostino abbagnale, rossano galtarossa	ITA	Rowing	1
sippy woodhead	USA	Swimming	1
slavomir knazovicky	SVK	Canoeing	1
s?ndor rozsny?l	HUN	Athletics	1
s?ndor wlad?r	HUN	Swimming	1
sofia assefa	ETH	Athletics	1
solenne figues	FRA	Swimming	1
sonia o'sullivan	IRL	Athletics	1
spiridon louis	GRE	Athletics	1
staciana stitts, courtney shealy, ashley tappin, dara torres, megan quann, bj bedford, jenny thompson, amy van dyken	USA	Swimming	1
stanislava komarova	RUS	Swimming	1
stanislawa walasiewicz	POL	Athletics	2
stanley vickers	GBR	Athletics	1
stan rowley	AUS	Athletics	2
stefani werremeier, ingeborg schwerzmann	GER	Rowing	1
stefan kaplaniak, wladyslaw zielinski	POL	Canoeing	1
stefano baldini	ITA	Athletics	1
stefano battistelli	ITA	Swimming	2
stefan pfeiffer	FRG	Swimming	2
stefan semmler, j?rgen thiele, siegfried brietzke, andreas decker	GDR	Rowing	1
stefan semmler, wolfgang mager, siegfried brietzke, andreas decker	GDR	Rowing	1
steffen bogs, heiko habermann, jens k?ppen, steffen z?hlke	GDR	Rowing	1
steffen zesner, christian tr?ger, oliver lampe, christian keller, aimo heilmann, konstantin dubrovin	GER	Swimming	1
stefka mihaylova madina, violeta nikolaeva ninova	BUL	Rowing	1
sten pettersson	SWE	Athletics	1
stepan oshchepkov, andrey khimich	URS	Canoeing	1
stephan caron	FRA	Swimming	2
stephan freigang	GER	Athletics	1
stephanie graf	AUT	Athletics	1
stephanie rice	AUS	Swimming	2
stephan moelvig, thor kristensen, eskild ebbesen, thomas ebert	DEN	Rowing	1
stephan volkert, andr? willms, andreas hajek, marco geisler	GER	Rowing	1
stephen anderson	USA	Athletics	1
stephen holland	AUS	Swimming	1
stephen kipkorir	KEN	Athletics	1
stephen kiprotich	UGA	Athletics	1
stephen parry	GBR	Swimming	1
steve clark, don schollander, roy saari, gary ilman	USA	Swimming	1
steve cram	GBR	Athletics	1
steve giles	CAN	Canoeing	1
steve lewis	USA	Athletics	2
steve lewis, kevin robinzine, butch reynolds, danny everett	USA	Athletics	1
steve lundquist	USA	Swimming	1
steve lysack, stephan macknowski	USA	Canoeing	1
steven blaisse, ernst veenemans	NED	Rowing	1
steven coppola, micah boyd, wyatt allen, josh inman, beau hoopman, bryan volpenhein, daniel walsh, matt schnobrich	USA	Rowing	1
steven furniss	USA	Swimming	1
steven genter	USA	Swimming	2
steven gregg	USA	Swimming	1
steven redgrave, matthew pinsent	GBR	Rowing	1
steven redgrave, matthew pinsent, timothy foster, james cracknell	GBR	Rowing	1
steve ovett	GBR	Athletics	2
stev theloke	GER	Swimming	1
st. george ashe	GBR	Rowing	1
stuart mackenzie	AUS	Rowing	1
suleiman nyambui	TAN	Athletics	1
summer sanders	USA	Swimming	3
sung-yong nam	JPN	Athletics	1
susan atwood	USA	Swimming	2
susan francia, anna goodale, erin cafaro, anna cummins, caryn davies, lindsay shoop, carl lind, elle logan	USA	Rowing	1
susanne gunnarsson-wiberg, agneta andersson	SWE	Canoeing	1
susanne nielsson	DEN	Swimming	1
susan o'neill	AUS	Swimming	4
susan pedersen	USA	Swimming	2
susan pedersen, jan henne, linda gustavson, jane barkman	USA	Swimming	1
susan rapp	USA	Swimming	1
susan shields	USA	Swimming	1
susanthika jayasinghe	SRI	Athletics	1
suzanne landells	AUS	Swimming	1
sven malm, agne holmstr?m, william petersson, nils sandstr?m	SWE	Athletics	1
svetlana babalina	URS	Swimming	1
svetlana masterkova	RUS	Athletics	2
svetlana varganova	URS	Swimming	1
sybil bauer	USA	Swimming	1
sybille sch?nrock	GDR	Swimming	1
sylviane felix, muriel hurtis, christine arron, veronique mang	FRA	Athletics	1
sylvia ruuska	USA	Swimming	1
sylvi saimo	FIN	Canoeing	1
szilvia szabo, erzsebet viski, rita k?b?n, katalin kovacs	HUN	Canoeing	1
szilvia szabo, katalin kovacs	HUN	Canoeing	1
taehwan park	KOR	Swimming	2
takashi ishimoto	JPN	Swimming	1
takashi yamamoto	JPN	Swimming	1
takashi yokoyama, masonori yusa, hisakichi toyoda, yasuji miyazaki	JPN	Swimming	1
takeshi matsuda	JPN	Swimming	2
tamas kiss, gyorgy kozmann	HUN	Canoeing	1
tam?s buday, oszk?r frey	HUN	Canoeing	1
tam?s darnyi	HUN	Swimming	4
tam?s wichmann	HUN	Canoeing	2
tania dangalakova	BUL	Swimming	1
tanya lawrence	JAM	Athletics	1
taoufik makhloufi	ALG	Athletics	1
tapio kantanen	FIN	Athletics	1
tariku bekele	ETH	Athletics	1
tarnee white, dyana calub, leisel jones, susan o'neill, petria thomas, giaan rooney, sarah ryan	AUS	Swimming	1
tarnee white, emily seebohm, lisbeth trickett, shayne reese, jessicah schipper, felicity galvez, leisel jones	AUS	Swimming	1
tasha danvers	GBR	Athletics	1
tatsugo kawaishi	JPN	Swimming	1
tatsuo fujimoto, makoto fukui, hiroshi ishii, tsuyoshi yamanaka	JPN	Swimming	1
tatyana anisimova	URS	Athletics	1
tatyana kazankina	URS	Athletics	3
tatyana korshunova	URS	Canoeing	1
tatyana ledovskaya	URS	Athletics	1
tatyana petrova arkhipova	RUS	Athletics	1
tatyana prorochenko, lyudmila maslakova, nadezhda besfamilnaya, vera anisimova	URS	Athletics	1
tatyana providokhina	URS	Athletics	1
tatyana tomashova	RUS	Athletics	1
tatyana veshkurova, tatiana firova, yulia gushchina, anastasia kapachinskaya, lyudmila litvinova, elena migunova	RUS	Athletics	1
tebbs lloyd-johnson	GBR	Athletics	1
tecla marinescu-borcanca, maria stefan-mihoreanu, nastasia ionescu, agafia constantin-buhaev	ROM	Canoeing	1
teddy flack	AUS	Athletics	2
ted meredith	USA	Athletics	1
ted murphy, sebastian bea	USA	Rowing	1
teijiro tanikawa, hiroshi suzuki, toru goto, yoshihiro hamaguchi	JPN	Swimming	1
teodor kocerka	POL	Rowing	2
teofilo yldefonzo	PHI	Swimming	2
terence parkin	RSA	Swimming	1
terrence trammell	USA	Athletics	2
terri stickles	USA	Swimming	1
tesfaye tola	ETH	Athletics	1
tetiana tereshchuk-antipova	UKR	Athletics	1
tetsuo hamuro	JPN	Swimming	1
tetsuo okamoto	BRA	Swimming	1
tetyana samolenko	URS	Athletics	1
tetyana semykina, inna osypenko, hanna balabanova, olena cherevatova	UKR	Canoeing	1
teun beijnen, wilhelm r?singh	NED	Rowing	1
thaddeus shideler	USA	Athletics	1
thane baker	USA	Athletics	3
theodore collet	GBR	Rowing	1
theodore mittet, richard lyon, geoffrey picard	USA	Rowing	1
theresa andrews	USA	Swimming	1
therese alshammar	SWE	Swimming	2
therese zenz	GER	Canoeing	2
therese zenz, ingrid hartmann	GER	Canoeing	1
theresia kiesl	AUT	Athletics	1
thiago pereira	BRA	Swimming	1
thomas battersby	GBR	Swimming	1
thomas bohrer, william burden, jeffrey mclaughlin, patrick manning	USA	Rowing	1
thomas evenson	GBR	Athletics	1
thomas fahrner	FRG	Swimming	1
thomas fahrner, michael gro?, dirk korthals, alexander schowtka	FRG	Swimming	1
thomas fahrner, michael gro?, erik hochstein, rainer henkel	FRG	Swimming	1
thomas farrell	USA	Athletics	1
thomas greiner, ralf brudel, olaf f?rster, roland schr?der	GDR	Rowing	1
thomas hall	CAN	Canoeing	1
thomas hampson	GBR	Athletics	1
thomas hicks	USA	Athletics	1
thomas hill	USA	Athletics	1
thomas jager	USA	Swimming	2
thomas jefferson	USA	Athletics	1
thomas lange	GDR	Rowing	1
thomas lange	GER	Rowing	2
thomas lurz	GER	Swimming	1
thomas mcbreen	USA	Swimming	1
thomas munkelt	GDR	Athletics	1
thomas pkemei longosiwa	KEN	Athletics	1
thomas ponting, mark tewksbury, stephen clarke, marcel gery	CAN	Swimming	1
thomas price, charles logg	USA	Rowing	1
thomas reineck, detlef hofmann, olaf winter, mark zabel	GER	Canoeing	1
thomas richards	GBR	Athletics	1
thomas rupprath, jens kruppa, helge meeuw, steffen driesen, lars conrad	GER	Swimming	1
thomas strau?, peter van roye	FRG	Rowing	1
thor henning	SWE	Swimming	1
thorvald str?mberg	FIN	Canoeing	1
tianfeng si	CHN	Athletics	1
tibor tatai	HUN	Canoeing	1
tiffany cohen	USA	Swimming	2
tiki gelana	ETH	Athletics	1
tim brabants	GBR	Canoeing	3
tim crooks, richard clark, hugh matheson, david maxwell, richard lester, leonard robertson, patrick sweeney, frederick smallbone, john yallop	GBR	Rowing	1
tim grohmann, lauritz schoof, karl schulze, phillipp wende	GER	Rowing	1
tim mckee	USA	Swimming	3
timothy foster, rupert obholzer, greg searle, jonathon searle	GBR	Rowing	1
timothy kitum	KEN	Athletics	1
timothy shaw	USA	Swimming	1
tim wiesk?tter, ronald rauhe	GER	Canoeing	1
tim young, eric mueller, brian jamieson, jason gailes	USA	Rowing	1
tina dietze, franziska weber	GER	Canoeing	1
tineke lagerberg	NED	Swimming	1
tinus osendarp	NED	Athletics	2
tirunesh dibaba	ETH	Athletics	5
t?nde szab?	HUN	Swimming	1
todd pearson, adam pine, ian thorpe, chris fydler, ashley callus, michael klim	AUS	Swimming	1
toimi pitk?nen, veli lehtel?	FIN	Rowing	1
toivo loukola	FIN	Athletics	1
tollef tollefsen, adolf nilsen, karl nag, theodor nag, arne mortensen, conrad olsen, thoralf hagen, thore michelsen, haakon ellingsen	NOR	Rowing	1
tom bruce	USA	Swimming	1
tom bruce, jerry heidenreich, mark spitz, michael stamm	USA	Swimming	1
tom burke	USA	Athletics	2
tom courtney	USA	Athletics	1
tom curtis	USA	Athletics	1
tom dolan	USA	Swimming	3
tom james, andrew triggs hodge, pete reed, alex gregory	GBR	Rowing	1
tom malchow	USA	Swimming	2
tommie smith	USA	Athletics	1
tommy green	GBR	Athletics	1
tommy karls, lars-erik moberg, thomas ohlsson, per-inge bengtsson	SWE	Canoeing	1
tomomi morita	JPN	Swimming	1
tom wilkens	USA	Swimming	1
tonie campbell	USA	Athletics	1
tonique williams-darling	BAH	Athletics	1
tonja buford-bailey	USA	Athletics	1
tonu endrekson, juri jaanson	EST	Rowing	1
tony dees	USA	Athletics	1
toos beumer, paulina van der wildt, winnie van weerdeburg, erica terpstra	NED	Swimming	1
tore sj?strand	SWE	Athletics	1
torri edwards, chryste gaines, marion jones, nanceen perry, chryste gaines, gail devers, inger miller, gwen torrence	USA	Athletics	1
torsten gutsche, kay bluhm	GER	Canoeing	1
toshio irie	JPN	Swimming	1
tove s?by	DEN	Canoeing	1
tracey caulkins	USA	Swimming	2
tracy cameron, melanie kok	CAN	Rowing	1
trine hansen	DEN	Rowing	1
tripp schwenk	USA	Swimming	1
tsegay kebede	ETH	Athletics	1
tsutomu oyokota	JPN	Swimming	1
tsuyoshi yamanaka	JPN	Swimming	3
tyler clary	USA	Swimming	1
uchenna emedolu, olusoji fasuba, aaron egbele, deji aliu	NGR	Athletics	1
ueli bodenmann, beat schwerzmann	SUI	Rowing	1
ugo frigerio	KIT	Athletics	1
ulrich eicke	FRG	Canoeing	1
ulrich kons, hans-peter koppe, ulrich karnatz, j?rg friedrich, bernd h?ing, uwe d?hring, jens dobersch?tz, bernd krau?, klaus-dieter ludwig	GDR	Rowing	1
ulrich papke, ingo spelly	GER	Canoeing	1
ulrike klapezynski	GDR	Athletics	1
ulrike richter	GDR	Swimming	2
ulrike tauber	GDR	Swimming	2
umberto bond?, pietro freschi, paolo gennari, cesare rossi	KIT	Rowing	1
ursula brunner, christel steffin, gisela wei?, heidi pechstein	GER	Swimming	1
ursula donath	GER	Athletics	1
ursula happe	GER	Swimming	1
usain bolt	JAM	Athletics	4
usain bolt, michael frater, nesta carter, yohan blake	JAM	Athletics	1
uta rohl?nder, anja r?cker, linda kisabaka, grit breuer	GER	Athletics	1
ute geweniger	GDR	Swimming	1
uwe da?ler	GDR	Swimming	2
uwe da?ler, thomas flemming, sven lodziewski, steffen zesner	GDR	Swimming	1
vadim yaroshchuk	URS	Swimming	1
?va d?nusz, rita k?b?n	HUN	Canoeing	1
vadzim makhneu, raman piatrushenka	BLR	Canoeing	1
valentina yegorova	RUS	Athletics	1
valentina yegorova	URS	Athletics	1
valentin boreyko, oleg golovanov	URS	Rowing	1
valentin massana	ESP	Athletics	1
valeria bufanu	ROM	Athletics	1
valerie brisco-hooks	USA	Athletics	2
valerie brisco-hooks, florence griffith-joyner, denean howard-hill	USA	Athletics	1
valerio arri	KIT	Athletics	1
valeriy borchin	RUS	Athletics	1
valery borzov	URS	Athletics	3
valery dolinin, aleksey kamkin, aleksandr kulagin, vitaly yeliseyev	URS	Rowing	1
val?ria gyenge	HUN	Swimming	1
vanderlei lima	BRA	Athletics	1
vanja gesheva-tsvetkova	BUL	Canoeing	2
vanja gesheva-tsvetkova, borislava ivanova, diana paliyska, ognyana petkova	BUL	Canoeing	1
?va nov?k	HUN	Swimming	3
?va nov?k, ilona nov?k, katalin sz?ke, judit temes	HUN	Swimming	1
?va rakusz, m?ria zakari?s	HUN	Canoeing	1
vasile diba	ROM	Canoeing	3
vasileios polymeros, dimitros mougios	GRE	Rowing	1
vasily arkhipenko	URS	Athletics	1
vasily yakusha	URS	Rowing	1
vasily yakusha, aleksandr marchenko	URS	Rowing	1
vasily yurchenko	URS	Canoeing	1
?va sz?kely	HUN	Swimming	2
v?clav chalupa	CZR	Rowing	1
v?clav koz?k, pavel schmidt	CZE	Rowing	1
vebj?rn rodal	NOR	Athletics	1
veenhoven, kingma, achterberg, de groot, repelaer van driel, belderbos, bouw, de haan, schellekens	NED	Rowing	1
veikko karvonen	FIN	Athletics	1
veniamin soldatenko	URS	Athletics	1
venuste niyongabo	BDI	Athletics	1
vera cochelea, elisabeta lipa	ROM	Rowing	1
vera komisova	URS	Athletics	1
vera tanner, constance jeans, grace mckenzie, florence barker	GBR	Swimming	1
veronica campbell	JAM	Athletics	3
veronica campbell, aleen bailey, sherone simpson, tanya lawrence	JAM	Athletics	1
veronica campbell-brown	JAM	Athletics	1
veronica campbell-brown, sherone simpson, kerron stewart, shelly-ann fraser-pryce	JAM	Athletics	1
vicente lima, andr? silva, edson ribeiro, claudinei da silva	BRA	Athletics	1
victor davis	CAN	Swimming	2
viktor denisov, aleksandr motuzenko, igor nagayev, sergey kirsanov	URS	Canoeing	1
viktor denisov, igor nagayev	URS	Canoeing	1
viktor flessl, leo losert	AUT	Rowing	1
viktor kakoshin, grigory dmitrenko, andrey tishchenko, aleksandr tkachenko, jonas pinskus, jonas narmontas, aleksandr matsevich, igor maystrenko, andrey lugin	URS	Rowing	1
viktor kuznetsov	URS	Swimming	1
viktor markin	URS	Athletics	1
viktor mazanov, igor grivennikov, georgi kulikov, vladimir bure	URS	Swimming	1
viktor mazanov, leonid ilyichov, georgi kulikov, semyon belitz-geyman	URS	Swimming	1
viktor mazanov, vladimir bure, viktor aboimov, igor grivennikov	URS	Swimming	1
viktor reneysky, nikola? juravschi	MDA	Canoeing	1
viktor reneysky, nikola? juravschi	URS	Canoeing	2
ville ritola	FIN	Athletics	5
vilma egresi, kl?ra fried-b?nfalvi	HUN	Canoeing	1
vincent duncker	DEU	Athletics	1
vincent matthews	USA	Athletics	1
violeta szekely	ROM	Athletics	1
violetta quesada, fulgencia romay, miguelina cobi?n, marlene elejarde	CUB	Athletics	1
viorica dumitru	ROM	Canoeing	1
viorica dumitru, maria nichiforov	ROM	Canoeing	1
viorica susanu, georgeta andrunache	ROM	Rowing	1
virginia duenkel	USA	Swimming	2
virginia lee, rebecca joyce	AUS	Rowing	1
vitaly galkov	URS	Canoeing	1
vitaly savin, vladimir muravyov, vladimir krylov, viktor bryzgin	URS	Athletics	1
vitaly sorokin, vladimir struzhanov, boris nikitin, gennady nikolayev	URS	Swimming	1
vivian cheruiyot	KEN	Athletics	2
vladek lacina, zdenek pecka, jaroslav hellebrand, v?clav vochoska	CZE	Rowing	1
vladimir andreyev	RUS	Athletics	1
vladimir bure	URS	Swimming	1
vladimir dolgov	URS	Swimming	1
vladimir golubnichy	URS	Athletics	4
vladimir kazantsev	URS	Athletics	1
vladimir kosinsky	URS	Swimming	2
vladimir kuts	URS	Athletics	2
vladimir morozov, aleksandr shaparenko	URS	Canoeing	1
vladimir parfenovich	URS	Canoeing	1
vladimir parfenovich, sergey chukhray	URS	Canoeing	1
vladimir raskatov	URS	Swimming	1
vladimir rodimushkin, yevgeny samsonov, igor polyakov, slava amiragov, yevgeny brago, igor borisov, leonid gissen, vladimir kryukov, aleksey komarov	URS	Rowing	1
vladimir salnikov	URS	Swimming	3
vladimir selkov	URS	Swimming	1
vladimir selkov, aleksandr popov, stanislav lopukhov, denis pankratov, roman ivanovskiy, vladislav kulikov, roman yegorov	RUS	Swimming	1
vladimir sukharyev, boris tokarev, leonid bartenev, yuri konovalov	URS	Athletics	1
vladimir sukharyev, levan sanadse, boris tokarev, levan kalyaev	URS	Athletics	1
vladimir volodenkov, dmitriy rozinkevich, roman monchenko, pavel melnikov, sergey matveyev, andrey glukhov, aleksandr lukyanov, nikolay aksyonov, anton chermashentsev	RUS	Rowing	1
vladim?r andrs, pavel hofman	CZE	Rowing	1
vladislav kulikov	RUS	Swimming	1
voitto hellst?n	FIN	Athletics	1
volker beck	GDR	Athletics	1
volmari iso-hollo	FIN	Athletics	4
voula patoulidou	GRE	Athletics	1
vyacheslav ivanenko	URS	Athletics	1
vyacheslav ivanov	URS	Rowing	3
waldemar cierpinski	GDR	Athletics	2
wallace o'connor, harrison glancy, ralph breyer, johnny weissmuller	USA	Swimming	1
wallace wolf, william smith, walter ris, james mclane	USA	Swimming	1
wally kinnear	GBR	Rowing	1
walter dix	USA	Athletics	2
walter laufer	USA	Swimming	1
walter mahlendorf, martin lauer, bernd cullmann, armin hary	GER	Athletics	1
walter rangeley	GBR	Athletics	1
walter ris	USA	Swimming	1
walter tewksbury	USA	Athletics	3
walther bathe	DEU	Swimming	1
warren kealoha	USA	Swimming	2
warren weir	JAM	Athletics	1
wayne collett	USA	Athletics	1
wayne frye, william fields, robert detweiler, james dunbar, charles manring, richard murphy, henry proctor, frank shakespeare, edward stevens	USA	Rowing	1
wendell mottley	TRI	Athletics	1
wendell mottley, edwin skinner, edwin roberts, kent bernard	TRI	Athletics	1
wendy boglioli	USA	Swimming	1
wendy weinberg	USA	Swimming	1
wenyi yang	CHN	Swimming	2
werner lampe	FRG	Swimming	1
werner lueg	GER	Athletics	1
whitney hedgepeth	USA	Swimming	2
wieger mensonides	NED	Swimming	1
wilfred bungei	KEN	Athletics	1
wilfried hartung, peter bruch, roland matthes, lutz unger	GDR	Swimming	1
wilhelmina von bremen	USA	Athletics	1
william burden, seth bauer, jonathan smith, michael teti, john rusher, ted patton, john pescatore, jeffrey mclaughlin, peter nordell	USA	Rowing	1
william crothers	CAN	Athletics	1
william dally, peter donlon, francis frederick, donald blessing, john brinck, hubert caldwell, marvin stalder, james workman, william thompson	USA	Rowing	1
william forrester	USA	Swimming	1
william frank	USA	Athletics	1
william gilmore	USA	Rowing	1
william gilmore, kenneth myers	USA	Rowing	1
william harris	USA	Swimming	1
william holland	USA	Athletics	1
william jordan, edward moore, alden sanborn, virgil jacomini, edwin graves, clyde king, donald johnston, vincent gallagher, sherman clark	USA	Rowing	1
william kirschbaum	USA	Swimming	1
william knecht, william stowe, stanley cwiklinski, harold budd, joseph amlong, thomas amlong, emory clark, hugh foley, r?bert zimonyi	USA	Rowing	1
william maher, john nunn	USA	Rowing	1
william miller	USA	Rowing	1
william miller, charles karle, george heales, ernest bayer	USA	Rowing	1
william mutwol	KEN	Athletics	1
william nichol, harold abrahams, lancelot royle, walter rangeley	GBR	Athletics	1
william porter	USA	Athletics	1
william robinson	GBR	Swimming	1
william sherring	CAN	Athletics	1
william smith	USA	Swimming	1
william tanui	KEN	Athletics	1
william varley, john mulcahy	USA	Rowing	1
william verner	USA	Athletics	1
william yorzyk	USA	Swimming	1
willie applegarth	GBR	Athletics	1
willie davenport	USA	Athletics	2
willie den ouden	NED	Swimming	1
willie may	USA	Athletics	1
willy l?tzow	DEU	Swimming	1
willy sch?rer	SUI	Athletics	1
wilma rudolph	USA	Athletics	2
wilma rudolph, margaret matthews, isabelle daniels, mae faggs, janet moreau, barbara jones, catherine hardy, mae faggs	USA	Athletics	1
wilma van rijn, manon van rooijen, inge de bruijn, chantal groot, thamar henneken	NED	Swimming	1
wilson boit kipketer	KEN	Athletics	1
wilson kipketer	DEN	Athletics	2
wilson kiprugut	KEN	Athletics	2
wilson kipsang kiprotich	KEN	Athletics	1
wiltrud urselmann	GER	Swimming	1
wim slijkhuis	NED	Athletics	2
wim van der kroft, nico tates	NED	Canoeing	1
winona zimmerman	USA	Swimming	1
winthrop graham	JAM	Athletics	1
winthrop graham, trevor grahem, bert cameron, howard davis, devon morris	JAM	Athletics	1
wolfgang g?ldenpfennig	GDR	Rowing	1
wolfgang hottenrott, michael schwan	GER	Rowing	1
wolfgang mager, siegfried brietzke	GDR	Rowing	1
wu you, gao yulan	CHN	Rowing	1
wyndham halswelle	GBR	Athletics	3
wyomia tyus	USA	Athletics	2
wyomia tyus, marilyn white, willye white, edith mcguire	USA	Athletics	1
xavier dorfman, jean-christophe bette, yves hocde, laurent porchier	FRA	Rowing	1
xenia stad-de jong, gerda van der kade-koudijs, nettie witziers-timmer, fanny blankers-koen	NED	Athletics	1
xeno m?ller	SUI	Rowing	2
xi aihua, tang bin, jin ziwei, zhang yangyang	CHN	Rowing	1
xiang liu	CHN	Athletics	1
xiaohong wang	CHN	Swimming	1
xiaomin huang	CHN	Swimming	1
ximena restrepo	COL	Athletics	1
xiuyun zhang, mianying cao	CHN	Rowing	1
xuanxu li	CHN	Swimming	1
xuejuan luo	CHN	Swimming	1
xu tianlongzi, zhou yafei, sun ye, pang jiaying, zhao jing	CHN	Swimming	1
yana dementyeva, kateryna tarasenko, anastasiia kozhenkova, nataliya dovgodko	UKR	Rowing	1
yana klochkova	UKR	Swimming	5
yang sun	CHN	Swimming	3
yang sun, yun hao, haiqi jiang, yunqi li	CHN	Swimming	1
yannick agnel	FRA	Swimming	1
yasuji miyazaki	JPN	Swimming	1
yasuko tajima	JPN	Swimming	1
yekaterina khodotovich	BLR	Rowing	3
yelena dendeberova	URS	Swimming	1
yelena khloptseva, yekaterina khodotovich, tatyana ustyuzhanina, antonina zelikovich	URS	Rowing	1
yelena kruglova, alla grishchenkova, natalya strunnikova, elvira vasilkova	URS	Swimming	1
yelena rudkovskaya	URS	Swimming	1
yelena zhupiyeva	URS	Athletics	1
yelyzaveta bryzgina, olesya povh, mariya ryemyen, hrystyna stuy	UKR	Athletics	1
yevgeny arzhanov	URS	Athletics	1
yevgeny gavrilenko	URS	Athletics	1
yevgeny ivchenko	URS	Athletics	1
yevgeny maskinsov	URS	Athletics	1
yevgeny penyaev	URS	Canoeing	1
yevgeny sadovyi	URS	Swimming	2
yevgeny seredin, sergey koplyakov, viktor kuznetsov, arsen miskarov	URS	Swimming	1
ying lu	CHN	Swimming	1
ying shan, huijue cai, yan chen, xue han	CHN	Swimming	1
yi tang	CHN	Swimming	1
yohan blake	JAM	Athletics	2
yong zhuang	CHN	Swimming	3
yong zhuang, wenyi yang, kun zhao, jingyi le, bin lu	CHN	Swimming	1
yordanka donkova	BUL	Athletics	2
yoshihiko osaki	JPN	Swimming	1
yoshihiro okumura, tomomi morita, kosuke kitajima, takashi yamamoto	JPN	Swimming	1
yoshinobu oyakawa	USA	Swimming	1
yoshiyuki tsuruta	JPN	Swimming	2
young-cho hwang	KOR	Athletics	1
yrj? hietanen, kurt wires, lars glass?r, ingemar hedberg	SWE	Canoeing	1
yrj? kolehmainen	FIN	Canoeing	1
yuko arimori	JPN	Athletics	2
yuko nakanishi	JPN	Swimming	1
yulia sotnikova, irina privalova, olga kotlyarova, svetlana gontcharenko	RUS	Athletics	1
yuliya bichyk, natallia helakh	BLR	Rowing	1
yuliya bogdanova	URS	Swimming	1
yuliya nesterenko	BLR	Athletics	1
yuliya ryabchynskaya	URS	Canoeing	1
yuliya zaripova	RUS	Athletics	1
yunxia qu	CHN	Athletics	1
yuri lituyev	URS	Athletics	1
yuriy borzakovskiy	RUS	Athletics	1
yuriy cheban	UKR	Canoeing	2
yury bachurov, igor akhremchik, valentin morkovkin, anatoly tarabrin	URS	Rowing	1
yury bashkatov, nikolay yevseyev, vladimir tkachenko, gennady prigoda	URS	Swimming	1
yury lobanov, vasily yurchenko	URS	Canoeing	1
yury lobanov, vladislavas cesiunas	URS	Canoeing	1
yury lorentson, juozas jagelavicius, valentin kravchuk, vladimir sterlik, viktor suslin, aleksandr martyshkin, antanas bagdonavicius, vytautas briedis, zigmas jukna	URS	Rowing	1
yury malyshev	URS	Rowing	1
yury postrigay, alexander dyachenko	RUS	Canoeing	1
yury stetsenko, valery didenko, yury filatov, vladimir morozov	URS	Canoeing	1
yury tyukalov	URS	Rowing	1
yury yakimov, vytautas butkus, yevgeny duleyev, aivars lazdenieks	URS	Rowing	1
zachary zorn, kenneth walsh, mark spitz, stephen rerych	USA	Swimming	1
zac purchase, mark hunter	GBR	Rowing	1
zbigniew jaremski, jerzy pietrzyk, ryszard podlas, jan werner	POL	Athletics	1
zdenek pecka, v?clav vochoska	CZE	Rowing	1
zdzislaw krzyszkowiak	POL	Athletics	1
zersenay tadesse	ERI	Athletics	1
zhang lin	CHN	Swimming	1
zhen wang	CHN	Athletics	1
zhou chunxiu	CHN	Athletics	1
zoltan kammerer, botond storcz	HUN	Canoeing	1
zoltan kammerer, tamas kulifai, daniel pauman, david toth	HUN	Canoeing	1
zolt?n bak?, istv?n szab?	HUN	Canoeing	1
zolt?n sztanity	HUN	Canoeing	1
zolt?n verraszt?	HUN	Swimming	2
zolt?n von halmay	HUN	Swimming	3
zolt?n von halmay, b?la von las torres, imre zach?r, j?zsef munk	HUN	Swimming	1
zoran pancic, milorad stanulov	YUG	Rowing	2
zsolt gyulai	HUN	Canoeing	2
zsolt gyulai, s?ndor h?dosi, ferenc csipes, attila ?brah?m	HUN	Canoeing	1
zuzana hejnova	CZE	Athletics	1
