Athlete	CountryCode	Medals
aage larsen, ebbe parsner	DEN	1
aaron peirsol	USA	5
aaron peirsol, michael phelps, jason lezak, ian crocker, brendan hansen, matt grevers, mark gangloff, garrett weber-gale	USA	1
a b bailey, phil boyd, george strange, pat reiffenstein, colonel rice, thomas loudon, donald mackenzie, william wadsworth, joseph wright	CAN	1
abdalaati iguider	MAR	1
abdon pamich	ITA	2
abdoulaye seye	FRA	1
abebe bikila	ETH	2
abel kiprop mutai	KEN	1
abel kirui	KEN	1
abel kiviat	USA	1
achim hill	GER	2
ada kok	NED	2
adalberts bubenko	LAT	1
adamski, kuffner, johannesen, reinelt, schmidt, mueller, mennigen, wilke, sauer	GER	1
adam van koeverden	CAN	4
addis abebe	ETH	1
adolph kiefer	USA	1
adriana bazon-chelariu, lulia bobeica, elena georgescu, viorica lepadatu, viorica neculai, ioana olteanu, maria paduraru, doina robu	ROM	1
adrian moorhouse	GBR	1
agnes geraghty	USA	1
agneta andersson	SWE	1
agneta andersson, anna olsson	SWE	1
agneta andersson, ingela ericsson, susanne rosenqvist, anna olsson	SWE	1
agneta andersson, susanne gunnarsson-wiberg	SWE	1
agneta andersson, susanne gunnarsson-wiberg, eva karlsson, anna olsson	SWE	1
agnieszka czopek	POL	1
agostino abbagnale, davide tizzano	ITA	1
ahmed salah	DJI	1
aigars fadejevs	LAT	1
aileen meagher, mildred dolson, hilda cameron, dorothy brookshaw	CAN	1
aileen riggin	USA	1
aina berg, wivan pettersson, gurli everlund, hj?rdis t?pel	SWE	1
ai shibata	JPN	1
aissa djabir said-guerni	ALG	1
akos vereckei, botond storcz, zoltan kammerer, g?bor horv?th	HUN	1
alain bernard	FRA	2
alain lebas	FRA	1
alain mimoun	FRA	4
alain mosconi	FRA	1
alajos szokolyi	HUN	1
alan campbell	GBR	1
alan ford	USA	1
alan grover, alfred duval, joseph fazio, peter dickson, david douglas, robert shirlaw, michael morgan, gary pearce, john ranch	AUS	1
alan mcclatchey, brian brinkley, gordon downie, david dunne	GBR	1
alan pascoe, martin reynolds, david jenkins, david hemery	GBR	1
alan thompson	NZL	1
albert coray	USA	1
albert hill	GBR	2
alberto cova	ITA	1
alberto demiddi	ARG	2
alberto juantorena	CUB	2
alberto zorrilla	ARG	1
albert schwartz	USA	1
albert vandeweghe	USA	1
albina osipowich	USA	1
albin lermusiaux	FRA	1
albin stenroos	FIN	2
alb?n vermes	HUN	1
alejandro casa?as	CUB	2
aleksandra fedoriva, yulia gushchina, yuliya chermoshanskaya, evgeniya polyakova	RUS	1
aleksandra gerasimenya	BLR	2
aleksandr anufriyev	URS	1
aleksandr berkutov, yury tyukalov	URS	2
aleksandr chayev	URS	1
aleksandr lukyanov, viktor omelyanovich, vasily tikhonov, andrey vasilyev, aleksandr dumchev, viktor diduk, veniamin but, nikolay komarov, pavel gurkovsky	URS	1
aleksandr maseykov, dmitry dovgalenok	URS	1
aleksandr popov	RUS	3
aleksandr popov	URS	2
aleksandr puchkov	URS	1
aleksandr rogov	URS	1
aleksandr shaparenko	URS	2
aleksandr sidorenko	URS	1
aleksandr silayev	URS	1
aleksandr vinogradov, sergey petrenko	URS	1
aleksey kudryavtsev, dmitry lepikov, vladimir pyshnenko, yury mukhin, veniamin tayanovich, yevgeny sadovyi	URS	1
aleksey voyevodin	RUS	1
alessandro lambruschini	ITA	1
alessia filippi	ITA	1
alessio sartori, romano battisti	ITA	1
alessio sartori, rossano galtarossa	ITA	1
alexander daleoen	NOR	1
alexander kostoglod, alexander kovalev	RUS	2
alexander luderitz, mark pinger, bengt zikarsky, bj?rn zikarsky, christian tr?ger	GER	1
alexander mcculloch	GBR	1
alexander wilson	CAN	2
alexander wilson, raymond lewis, james ball, philip edwards	CAN	1
alexander wilson, stanley glover, philip edwards, james ball	CAN	1
alexandra barr?, sue holloway	CAN	1
alexandra tsiavou, christina giazitzidou	GRE	1
alexandre jany, aldo eminente, jean boiteux, joseph bernardo	FRA	1
alexandre jany, henri padou, ren? cornu, joseph bernardo	FRA	1
alex baumann	CAN	2
alexe dumitru, simion ismailciuc	ROM	1
alexey korovashkov, ilya pervukhin	RUS	1
alex schwazer	ITA	1
alf hansen, frank hansen	NOR	1
alf hansen, lars bj?nness, vetle vinje, rolf thorsen	NOR	1
alfons dorfner, adolf kainz	AUT	1
alfr?d haj?s	HUN	1
alfred bachmann, heinrich fischer	SUI	1
alfred dompert	GER	1
alfred healey	GBR	1
alfred sageder, josef kloimstein	AUT	1
alfred tysoe	GBR	1
alfred wilson, howard kingsbury, leonard carpenter, john miller, al lindley, james rockefeller, benjamin spock, laurence stoddard, frederick sheffield	USA	1
alfred yego	KEN	1
aliaksandr bahdanovich, andrei bahdanovich	BLR	2
aliaksei abalmasau, raman piatrushenka, vadzim makhneu, artur litvinchuk	BLR	1
alice bridges	USA	1
alice brown	USA	1
alice mills, petria thomas, giaan rooney, brooke hanson, jodie henry, leisel jones, jessicah schipper	AUS	1
alicia coutts	AUS	2
ali ezzine	MAR	1
ali saidi-sief	ALG	1
allan lawrence	AUS	1
allan wells	GBR	2
allan wood	AUS	2
allen johnson	USA	1
allen stack	USA	1
allen woodring	USA	1
allison schmitt	USA	2
allison wagner	USA	1
allyson felix	USA	3
allyson felix, deedee trotter, sanya richards-ross, francena mccorory	USA	1
allyson felix, tianna madison, bianca knight, carmelita jeter	USA	1
alonzo babers	USA	1
alva colqhoun, lorraine crapp, dawn fraser, ilsa konrads	AUS	1
alvah meyer	USA	1
alvin harrison	USA	1
alvin harrison, derek mills, lamont smith, anthuan maybank	USA	1
alvin kraenzlein	USA	1
alwyn morris, hugh fisher	CAN	1
amadou dia b?	SEN	1
amanda beard	USA	5
amaury leveaux	FRA	1
amaury leveaux, clement lefert, gregory mallet, yannick agnel	FRA	1
ambrose gaines	USA	1
amos biwott	KEN	1
amy van dyken	USA	2
amy van dyken, jenny thompson, angel martino, kristine quance, catherine fox, amanda beard, beth botsford, whitney hedgepeth	USA	1
amy white	USA	1
ana guevara	MEX	1
ana quirot	CUB	2
anastasia zueva	RUS	1
anatoly grishin, nikolay chuzhikov, vyacheslav ionov, vladimir morozov	URS	1
anatoly mikhaylov	URS	1
anatoly sass, aleksandr timoshinin	URS	1
anca patrascoiu	ROM	1
anders g?rderud	SWE	1
anders holmertz	SWE	3
anders holmertz, lars fr?lander, tommy werner, christer wallin	SWE	1
andrea gyarmati	HUN	2
andrea pollack	GDR	3
andrea pollack, claudia hempel, kornelia ender, petra priemer	GDR	1
andrea pollack, hannelore anke, kornelia ender, ulrike richter	GDR	1
andreas dittmer	GER	4
andreas dittmer, gunar kirchbach	GER	1
andreas hajek, andr? steiner, stephan volkert, andr? willms	GER	1
andreas ihle, martin hollstein	GER	1
andreas st?hle	GDR	1
andreas szigat, christian tr?ger, mark pinger, dirk richter, jonathon cleveland, steffen zesner, bengt zikarsky	GER	1
andrei igorov	ROM	1
andre phillips	USA	1
andrew byrnes, kyle hamilton, malcolm howard, adam kreek, ben rutledge, brian price, kevin light, jake wetzel, dominic sieterle	CAN	1
andrew charlton	AUS	4
andrew charlton, maurice christie, frank beaurepaire, ernest henry	AUS	1
andrew jameson	GBR	1
andrew lauterstein	AUS	1
andrew lauterstein, patrick murphy, ashley callus, leith brodie, eamon sullivan, matt targett	AUS	1
andrew triggs-hodge, steve williams, peter reed, tom james	GBR	1
andrew trim, danny collins	AUS	1
andrey bogdanov, sergey koplyakov, andrey krylov, vladimir raskatov	URS	1
andrey grechin, danila izotov, nikita lobintsev, vladimir morozov	RUS	1
andrey korneyev	RUS	1
andrey krylov	URS	2
andrey perlov	URS	1
andrey smirnov	URS	1
andr? gaudin	FRA	1
andrian dushev, milko kazanov	BUL	1
andriy serdinov	UKR	1
andr?s hargitay	HUN	1
andr? silva, arnaldo silva, edson ribeiro, robson da silva	BRA	1
andr? wohllebe	GDR	1
andr? wohllebe, andreas st?hle, hans-j?rg bliesener, kay bluhm	GDR	1
andrzej badewski	POL	1
andrzej gronowicz, jerzy opara	POL	1
andrzej zieliwski, wieslaw maniak, marian foik, marian dudziak	POL	1
andy holmes, steven redgrave	GBR	1
andy stanfield	USA	2
aneta konieczna, beata mikolajczyk	POL	1
aneta pastuszka, beata sokolowska	POL	2
anette r?ckes, rita wilden, hildegard falck, inge b?dding	FRG	1
anett schuck, manuela mucke, birgit fischer, katrin wagner	GER	1
angela alupei, constanta burcica-pipota	ROM	1
angela bailey, france gareau, angella taylor, marita payne	CAN	1
angela kennedy, helen denman, samantha riley, sarah ryan, nicole stevenson, susan o'neill	AUS	1
angel martino	USA	3
angelo taylor	USA	2
angelo taylor, tony mcquay, bryshon nellum, joshua mance	USA	1
anier garcia	CUB	2
anita lonsbrough	GBR	1
anita nall	USA	2
anke m?hring	GDR	1
anna olsson, susanne rosenqvist, maria haglund, agneta andersson	SWE	1
anna pfeffer	HUN	1
anna pfeffer, katalin rozsny?i	HUN	1
anna seaton, stephanie maxwell-pierson	USA	1
ann curtis	USA	2
annegret richter	FRG	2
annelie ehrhardt	GDR	1
annelies bredael	BEL	1
anne marden	USA	1
annemarie cox, annemiek derckx	NED	1
annemarie verstappen	NED	2
annemiek de haan, hurnet dekkers, nienke hommes, esther worhel, froukje wegman, annemarieke van rumpt, marlies smulders, helen tanger, sarah siegelaar	NED	1
annemiek derckx	NED	1
anne ottenbrite	CAN	2
anne poleska	GER	1
annie vernon, debbie flood, katherine grainger, frances houghton	GBR	1
anni holdmann, leni junker, rosa kellner, leni schmidt	GER	1
ann jardin, wendy hogg, robin corsiglia, susan sloan	CAN	1
ann packer	GBR	2
antal kiss	HUN	1
antal r?ka	HUN	1
antanas mikenas	URS	1
anthony edwards, ben cureton, simon burgess, glen loftus	AUS	1
anthony edwards, bruce hick	AUS	1
anthony ervin	USA	1
anthony mosse	NZL	1
anthony nesty	SUR	2
antje buschschulte	GER	1
antje buschschulte, kerstin kielga?, sara harstick, franziska van almsick	GER	1
antje buschschulte, meike freitag, simone osygus, sandra v?lker, franziska van almsick	GER	1
antoaneta frenkeva	BUL	2
antoine richard, hermann panzo, pascal barr?, patrick barr?	FRA	1
antonel borsan, marcel glavan	ROM	1
antonina melnikova	URS	1
antonina seredina	URS	1
antonina seredina, lyudmila pinayeva-khvedosyuk	URS	1
antonina seredina, mariya shubina	URS	1
antonio leit?o	POR	1
antonio mckay	USA	1
antonio pettigrew, alvin harrison, calvin harrison, michael johnson	USA	1
antonio rossi	ITA	1
antonio rossi, beniamino bonomi	ITA	2
antonio rossi, bruno dreossi	ITA	1
antonio scaduto, andrea facchin	ITA	1
antti kasvio	FIN	1
archibald mckinnon, lorne loomer, donald arnold, ignace d'hondt	CAN	1
archie hahn	USA	3
archie williams	USA	1
ardalion ignatyev	URS	1
aries merritt	USA	1
arkady vyatchanin	RUS	2
armas toivonen	FIN	1
armin hary	GER	1
arne bergodd, rolf andreassen, ole nafstad, finn tveter	NOR	1
arne borg	SWE	4
arne borg, ?ke borg, georg werner, orvar trolle	SWE	1
arne nielsson, christian wig?	DEN	1
arno bieberstein	DEU	1
arnold jackson	GBR	1
arnold jonke, christoph zerbst	AUT	1
arsen miskarov	URS	2
arthur ayrault, john sayre, ted nash, rusty wailes	USA	1
arthur barnard	USA	1
arthur blake	USA	1
arthur jonath	GER	1
arthur newton	USA	2
arthur porritt	NZL	1
arthur schwab	SUI	1
arthur shaw	USA	1
arthur wint	JAM	3
arto bryggare	FIN	1
artur svensson, gustav weijnarth, nils engdahl, erik byl?hn	SWE	1
artur wojdat	POL	1
arvidas juozaitis	URS	1
arvo aaltonen	FIN	1
arvo askola	FIN	1
arvo ojanper?	FIN	1
asafa powell, michael frater, nesta carter, usain bolt, dwight thomas	JAM	1
asbel kiprop	KEN	1
ashley tappin, jenny thompson, angel martino, nicole haislett, crissy ahmann-leighton, dara torres	USA	1
asli cakir alptekin	TUR	1
assefa mezgebu	ETH	1
astrid strau?	GDR	1
atanase sciotnic, aurel vernescu, mihai turcas, simion cuciuc	ROM	1
athanasia tsoumeleka	GRE	1
ato boldon	TRI	4
attila adrovicz, ferenc csipes, andr?s rajna, g?bor horv?th	HUN	1
attila ?brah?m, ferenc csipes	HUN	1
attila ?brah?m, ferenc csipes, zsolt gyulai, l?szl? fidel	HUN	1
attila czene	HUN	2
attila vajda	HUN	2
audrey patterson	USA	1
audrey williamson	GBR	1
audun boysen	NOR	1
august desch	USA	1
aurel vernescu	ROM	1
aurica barascu, georgeta damian, doina ignat, elena georgescu, rodica florea, liliana gafencu, viorica susanu, ioana papuc, elisabeta lipa	ROM	1
aya terakawa	JPN	1
aya terakawa, yuka kato, haruka ueda, satomi suzuki	JPN	1
barbara burke, audrey brown, eileen hiscock, violet olney	GBR	1
barbara ferrell	USA	1
barbara g?bel	GER	1
barbara jones, martha hudson, wilma rudolph, lucinda williams	USA	1
barbara krause	GDR	2
barbara olmsted, lucie guay, sue holloway, alexandra barr?	CAN	1
barbara sch?ttpelz	FRG	1
barney ewell	USA	2
barry kelly, grant kenny	AUS	1
barry magee	NZL	1
basil heatley	GBR	1
beata mikolajczyk, karolina naja	POL	1
beatrice caslaru	ROM	2
beatrice lyons	AUS	1
beatrice utondu, mary onyali, christy opara-thompson, faith idehen	NGR	1
beaufort burdekin, robert bourne, william fison, thomas gillespie, john walker, arthur wiggins, charles littlejohn, william parker, frederick pitman	GBR	1
becky smith	CAN	1
becky smith, gail amundrud, barbara clark, ann jardin	CAN	1
ben eastman	USA	1
ben fouhy	NZL	1
bengt baron	SWE	1
ben hunt-davis, simon dennis, rowley douglas, louis attrill, steve trapmore, kieran west, andrew lindsay, luka grubor, fred scarlett	GBR	1
beniamino bonomi	ITA	1
beniamino bonomi, daniele scarpa	ITA	1
benita fitzgerald-brown	USA	1
benjamin kogo	KEN	1
ben jipcho	KEN	1
ben johnson	CAN	1
ben johnson, tony sharpe, sterling hinds, desai williams	CAN	1
benny nielsen	DEN	1
bent rasch, finn haunstoft	DEN	1
bergen, csima, gibson, mccabe, howard, byrnes, brown, crothers, price	CAN	1
bernard bregeon	FRA	1
bernard lagat	KEN	2
bernardo sugura	MEX	1
bernard williams iii	USA	1
bernd duvigneau, r?diger helm, frank-peter bischof, j?rgen lehnert	GDR	1
bernd kannenberg	FRG	1
bernd landvoigt, j?rg landvoigt	GDR	2
bernd landvoigt, j?rg landvoigt, hans-joachim borzym, harold dimke, heinrich mederow, dietmar schwarz, manfred schmorde, manfred schneider, hartmut schreiber	GDR	1
bernd olbricht, joachim mattern	GDR	1
bernhard von gaza	DEU	1
bershawn jackson	USA	1
bertha brouwer	NED	1
bertil albertsson	SWE	1
bertrand vecten, olivier moncelet, gilles bosquet, daniel fauche	FRA	1
beth botsford	USA	1
betsy mitchell	USA	1
betty cuthbert	AUS	3
beverley whitfield	AUS	2
beverly mcdonald	JAM	1
bevil rudd	SAF	2
bill carr	USA	1
bill dellinger	USA	1
bill hogenson	USA	2
bill mulliken	USA	1
billy mills	USA	1
birgit fischer	GDR	2
birgit fischer	GER	1
birgit fischer, anke nothnagel-von seck	GDR	1
birgit fischer, carolin leonhardt	GER	1
birgit fischer, katrin wagner	GER	1
birgit fischer, ramona portwich	GER	1
birgit fischer, ramona portwich, anett schuck, manuela mucke	GER	1
birgit fischer, ramona portwich, heike singer, anke nothnagel-von seck	GDR	1
birgit peter, martina schr?ter	GDR	1
birgit treiber	GDR	3
birte weigang	GDR	2
birte weigang, kathrin mei?ner, kristin otto, silke h?rner	GDR	1
birute sakickiene, kristina poplavskaja	LTU	1
bisi afolabi, falilat ogunkoya, charity opara, fatima yusuf	NGR	1
bjorn bach, jan sch?fer, stefan ulm, mark zabel	GER	1
bj?rn hasl?v, kurt helmudt, john hansen, erik petersen	DEN	1
b?la goldov?nyi, gy?rgy cs?nyi, l?szl? zar?ndi, g?za varasdi	HUN	1
blain lindgren	USA	1
blair horn, mark evans, michael evans, dean crawford, grant main, kevin neufeld, brian mcmahon, paul steele, patrick turner	CAN	1
bobby morrow	USA	2
bobby pearce	AUS	2
bob hayes	USA	1
bob leavitt	USA	1
bob schul	USA	1
bob sohl	USA	1
bob tisdall	IRL	1
bodo t?mmler	FRG	1
bo gustafsson	SWE	1
bohuslav karl?k	CZE	1
bong-ju lee	KOR	1
bonnie mealing	AUS	1
borislav ananiev, nikolay ilkov	BUL	1
borislav borisov, lazar khristov, bozhidar milenkov, ivan manev	BUL	1
boris steimetz, fabien gilot, alain bernard, fr?d?rick bousquet, amaury leveaux, gregory mallet	FRA	1
botond storcz, g?bor horv?th, zoltan kammerer, akos vereckei	HUN	1
bouguerra el quafi	FRA	1
bowen stassforth	USA	1
brad bridgewater	USA	1
bradford cooper	AUS	1
bradley lewis, paul enquist	USA	1
brahim boutayeb	MAR	1
brahim lahlafi	MAR	1
b?rbel w?ckel-eckert	GDR	2
b?rbel w?ckel-eckert, renate stecher, carla bodendorf, marlies g?hr-oelsner	GDR	1
brenda helser, thelma kalama, marie corridon, ann curtis	USA	1
brenda jones	AUS	1
brendan foster	GBR	1
brendan hansen	USA	3
brendan hansen, michael phelps, nathan adrian, matthew grevers	USA	1
brent hayden	CAN	1
brenton rickard	AUS	1
brian diemer	USA	1
brian goodell	USA	2
brian job	USA	1
brian peaker, dave boyes, gavin hassett, jeffrey lay	CAN	1
bridgitte hartley	RSA	1
brigita bukovec	SLO	1
brimin kiprop	KEN	1
brimin kipruto	KEN	1
britta oppelt, annekatrin thiele, carina baer, julia richter	GER	1
britta oppelt, peggy waleska	GER	1
britta steffen	GER	2
britta steffen, meike freitag	GER	1
bronislaw malinowski	POL	2
bronte barratt	AUS	1
bronte barratt, alicia coutts, kylie palmer, melanie schlanger	AUS	1
brooke bennett	USA	3
brooke hanson	AUS	1
bruce furniss	USA	1
bruce robertson	CAN	1
bruno boni, felice fanetti	ITA	1
bruno junk	URS	1
bruno mascarenhas, lorenzo bertini, catello amarante, salvatore amitrano	ITA	1
bud spencer, frederick alderman, george baird, raymond barbuti	USA	1
buffy alexander, laryssa biesenthal, heather davis, alison korn, theresa luke, emma robinson, heather mcdermid, dorota urbaniak, lesley thompson	CAN	1
buster crabbe	USA	2
butch reynolds	USA	1
cafaro, francia, lofgren, ritzel, musnicki, logan, lind, davies, whipple	USA	1
caitlin leverenz	USA	1
calvin davis	USA	1
calvin smith	USA	1
camelia potec	ROM	1
cameron henning	CAN	1
cameron van der burgh	RSA	1
camille muffat	FRA	2
caren metschuck	GDR	2
caren metschuck, andrea pollack, ute geweniger, rica reinisch	GDR	1
carina ljungdahl, agneta eriksson, tina gustafsson, agneta m?tensson	SWE	1
carin cone	USA	1
carin ter beek, pieta van dishoeck, eeke van nes, anneke venema, marieke westerhof, nelleke penninx, elien meijer, martijntje quik, tessa appeldoorn	NED	1
carl kaufmann	GER	1
carl lewis	USA	4
carlo monti, michele tito, enrico perucconi, antonio siddi	ITA	1
carlos mercenario	MEX	1
carlos perez, saul craviotto	ESP	1
carlos sousa lopes	POR	2
carl robie	USA	2
carmela schmidt	GDR	2
carmelita jeter	USA	2
carola zirzow	GDR	1
carola zirzow, b?rbel k?ster	GDR	1
carolina evers-swindell, georgina evers-swindell	NZL	2
caroline brunet	CAN	3
carolin martina leonhardt, katrin wagner-augustin, tina dietze, franziska weber	GER	1
carolyn schuler	USA	1
carolyn schuler, chris von saltza, lynn burke, patty kempner	USA	1
carrie steinseifer	USA	1
carrie steinseifer, dara torres, nancy hogshead, jenna johnson	USA	1
carsta gen?u?, martina bischof	GDR	1
caster semenya	RSA	1
cate campbell	AUS	1
cate campbell, alice mills, shayne reese, melanie schlanger, lisbeth trickett	AUS	1
cate campbell, alicia coutts, melanie schlanger, brittany elmslie	AUS	1
cath bishop, katherine grainger	GBR	1
catherine carr	USA	1
catherine fox, lisa jacob, angel martino, jenny thompson, melanie valerio, amy van dyken	USA	1
catherine gibson	GBR	1
catherine ndereba	KEN	2
catherine plewinski	FRA	2
catherine poirot	FRA	1
cathleen rund	GER	1
cathy ferguson	USA	1
cathy freeman	AUS	2
cecil healy	ANZ	1
cecil healy	AUS	1
cecil healy, leslie boardman, malcolm champion, harold hardwick	ANZ	1
cerstin petersmann, dana pyritz, daniela neunast, judith zeidler, ute wagner-stange, annegret strauch, kathrin haacker, christiane harzendorf, sylvia d?rdelmann	GER	1
cesar cielofilho	BRA	2
cesar cielo filho	BRA	1
cesare milani, enrico garzelli, guglielmo del bimbo, renato bracci, mario balleri, renato barbieri, dino barsotti, vittorio cioni, roberto vestrini	KIT	1
chad le clos	RSA	2
chandra cheeseborough	USA	1
chandra cheeseborough, jeanette bolden, alice brown, evelyn ashford	USA	1
chandra sturrup, sevatheda fynes, pauline davis-thompson, eldece clark	BAH	1
charilaos vasilakos	GRE	1
charles asati, hezekiah nyamau, robert ouko, julius sang	KEN	1
charles bacon	USA	1
charles bennett	GBR	1
charles borah, jimmy quinn, frank wykoff, hank russell	USA	1
charles burnell, raymond etherington-smith, henry bucknall, albert gladstone, gilchrist maclagen, banner johnstone, frederick kelly, guy nickalls, ronald sanderson	GBR	1
charles chandler, james blair, david dunlap, norris graham, duncan gregg, winslow hall, harold tower, edwin salisbury, burton jastram	USA	1
charles daniels	USA	2
charles day, gordon adam, donald hume, george hunt, james mcmillin, bob moch, herbert morris, joseph rantz, john white	USA	1
charles gmelin	GBR	1
charles hefferon	SAF	1
charles hickcox	USA	3
charles hickcox, donald mckenzie, kenneth walsh, douglas russell	USA	1
charles jenkins	USA	1
charles lelong, pierre failliot, robert schurrer, charles poulenard	FRA	1
charles moore	USA	1
charles paddock	USA	3
charles reidpath	USA	1
charles spedding	GBR	1
charlie greene	USA	1
charlotte radcliffe, hilda james, constance jeans, grace mckenzie	GBR	1
charmaine crooks, molly killingbeck, marita payne, jillian richardson	CAN	1
cheryl gibson	CAN	1
chester jastremski	USA	1
chris brasher	GBR	1
chris jacobs	USA	1
chris jacobs, matt biondi, david berkoff, richard schroeder	USA	1
chris mahoney, duncan mcdougall, malcolm mcgowan, colin moynihan, john pritchard, richard stanhope, john clay, andrew justice, allan whitwell	GBR	1
christa stubnick	GER	2
chris thompson	USA	1
christiane huth, annekatrin thiele	GER	1
christiane knacke	GDR	1
christiane pielke, iris zscherpe, susanne schuster, karin seick	FRG	1
christiane wartenberg	GDR	1
christian gille, tomasz wylenzek	GER	3
christian gitsham	SAF	1
christian ryan, nick porzig, mike mckay, stuart welch, robert jahrling, brett hayman, alastair gordon, daniel burke, jaime fernandez	AUS	1
christian sprenger	AUS	1
christian sprenger, hayden stoeckel, matt targett, james magnussen	AUS	1
christina lathan-brehmer	GDR	2
christina lathan-brehmer, barbara krug, marita koch, gabriele l?we	GDR	1
christina lathan-brehmer, doris maletzki, brigitte rohde, ellen streidt	GDR	1
christine collins, sarah garner	USA	1
christine gosse, h?l?ne cortin	FRA	1
christine magnuson	USA	1
christine ohuruogu	GBR	2
christine wachtel	GDR	1
christoph h?hne	GDR	1
chris von saltza	USA	2
chris von saltza, shirley stobs, joan spillane, carolyn wood	USA	1
chris williams, danny mcfarlane, michael blackwood, greg haughton	JAM	1
claire dennis	AUS	1
clarence demar	USA	1
clarke scholes	USA	1
claude piquemal, g?rard f?nouil, jocelyn delecour, roger bambuck	FRA	1
claudia blasberg, daniela reimer	GER	1
claudia blasberg, valerie viehoff	GER	1
claudia kolb	USA	3
claudia poll	CRC	3
claudia zaczkiewicz	FRG	1
clement chukwu, sunday bada, jude monye, enefiok udo-obong	NGR	1
cliff cushman	USA	1
clinton hill, patrick dwyer, mark ormrod, john steffensen	AUS	1
clint robinson	AUS	2
clint robinson, nathan baggaley	AUS	1
clyde hefer, stephen evans, james battersby, ian edmunds, craig muller, sam patten, ion popa, gavin thredgold, timothy willoughby	AUS	1
clyde scott	USA	1
colette besson	FRA	1
colin jackson	GBR	1
colin smith, tom stallard, josh west, matthew langridge, tom lucy, alex partridge, alastair heathcote, richard egington	GBR	1
colin von ettingshausen, peter h?ltzenbein	GER	1
colleen lanne, kara lynn joyce, maritza correia, lindsay benko, natalie coughlin, amanda weir, jenny thompson	USA	1
con cochran, alan helffrich, oliver macdonald, bill stevenson	USA	1
conny van bentum, desi reijers, annemarie verstappen, elles voskes	NED	1
conny van bentum, marianne muis, mildred muis, karin brienese	NED	1
conny van bentum, wilma van velsen, reggie de jong, annelies maas	NED	1
conny wassmuth, katrin wagner, fanny fischer, nicole reinhardt	GER	1
conrad robertson, shane o'brien, les o'connell, keith trask	NZL	1
constance titus	USA	1
constanta burcica-pipota, angela alupei	ROM	1
constanta burcica-pipota, camelia macoviciuc	ROM	1
constantina tomescu	ROM	1
cornelia polit	GDR	1
cornelia sideri, hilde lauer	ROM	1
cornelia sirch	GDR	2
costica olaru	ROM	1
courtney shealy, ashley tappin, dara torres, erin phenix, amy van dyken, jenny thompson	USA	1
craig dixon	USA	1
crissy ahmann-leighton	USA	1
cristiena cojocaru	ROM	1
cristina teuscher	USA	1
csaba giczi, istv?n tim?r	HUN	1
csaba horv?th, gy?rgy kolonics	HUN	2
cullen jones	USA	1
curtis myden	CAN	3
cyril gill, jack london, edward smouha, walter rangeley	GBR	1
cyril stiles, fred thompson	NZL	1
dagmar hase	GER	5
daichi suzuki	JPN	1
dana schoenfield	USA	1
dana vollmer	USA	1
dana vollmer, allison schmitt, missy franklin, shannon vreeland	USA	1
dana vollmer, allison schmitt, rebecca soni, missy franklin	USA	1
dana vollmer, rhi jeffrey, lindsay benko, natalie coughlin, carly piper, kaitlin sandeno, rachel komisarz	USA	1
daniela hunger	GDR	2
daniela hunger	GER	1
daniela hunger, kathrin mei?ner, kristin otto, manuela stellmach	GDR	1
daniela neunast, ute wild, ute wagner-stange, beatrix schr?er, annegret strauch, ramona balthasar, anja kluge, kathrin haacker, judith zeidler	GDR	1
daniela walkowiak?wna	POL	1
daniel barrow	USA	1
daniel bautista	MEX	1
daniele scarpa, antonio rossi	ITA	1
daniel gyurta	HUN	2
daniel harrigan	USA	1
daniel jedraszko, pawel baraszkiewicz	POL	1
daniel kowalski	AUS	3
daniel plaza	ESP	1
daniel sangouma, gilles qu?n?herv?, max morini?re, bruno marie-rose	FRA	1
dan kinsey	USA	1
danny collins, andrew trim	AUS	1
danny everett	USA	1
danny harris	USA	1
danny mcfarlane	JAM	1
danuta kozak	HUN	1
danut dobre, marin gheorghe, vasile lonel mastacan, claudiu gabriel marin, vasile dorel nastase, loan lulian vizitiu, iulica ruican, viorel talapan, valentin robu	ROM	1
danyon loader	NZL	3
daphne hasenjager	SAF	1
dara torres	USA	4
darcy hadfield	NZL	1
dario dentale, luca agamennoni, lorenzo porzio, raffaello leonardo	ITA	1
darren campbell	GBR	1
dave hall	USA	1
dave wottle	USA	1
davian clarke, greg haughton, michael mcdonald, roxbert martin	JAM	1
david berkoff	USA	2
david cal	ESP	5
david collins, william carlucci, jeff pfaendtner, marc schneider	USA	1
david crawshay, scott brennan	AUS	1
david davies	GBR	1
davide rummolo	ITA	1
david fox, scott tucker, jon olsen, brad schumacher, josh davis, gary hall jr.	USA	1
david gillanders	USA	1
david grindley, kriss akabusi, roger black, john regis	GBR	1
david hemery	GBR	2
david jacobs, henry macintosh, vic d'arcy, willie applegarth	GBR	1
david kopriva, jakub hanak, david jirka, tomas karas	CZR	1
david larsen, bruce hayes, mike heath, jeffrey float, geoffrey gaberino	USA	1
david lekuta rudisha	KEN	1
david lowe, duncan goodhew, gary abraham, trevor smith	GBR	1
david l?pez-zubero	ESP	1
david neville	USA	1
david oliver	USA	1
david payne	USA	1
david power	AUS	1
david segal, peter radford, neville whitehead, david jones	GBR	1
david sime	USA	1
david theile	AUS	2
david townsend, ian mcnuff, martin cross, john beattie	GBR	1
david wharton	USA	1
david wilkie	GBR	3
david wilson	USA	1
davis kamoga	UGA	1
dawn fraser	AUS	4
dawn harper	USA	2
dayron robles	CUB	1
debbie ferguson	BAH	1
debbie flintoff-king	AUS	1
debbie flood, frances houghton, alison mowbray, rebecca romero	GBR	1
debbie meyer	USA	3
debra sapenter, rosalyn bryant, pamela jiles, sheila ingram	USA	1
deedee trotter	USA	1
deena kastor	USA	1
dejen gebremeskel	ETH	1
delfo cabrera	ARG	1
demitrios golemis	GRE	1
denis alexeev, vladislav frolov, maksim dyldin, anton kokorin	RUS	1
denis nizhegorodov	RUS	2
denis pankratov	RUS	2
denis pimankov, roman yegorov, vladimir predkin, vladimir pyshnenko, aleksandr popov	RUS	1
dennis mitchell	USA	1
dennis mitchell, mike marsh, carl lewis, leroy burrell	USA	1
denys sylant'yev	UKR	1
deon hemmings	JAM	2
deon hemmings, lorraine graham, sandie richards, catherine scott-pomales	JAM	1
derartu tulu	ETH	3
derek ibbotson	GBR	1
derek johnson	GBR	1
derek porter	CAN	1
derrick adkins	USA	1
derrick brew	USA	1
derrick brew, otis harris jr, darold williamson, jeremy wariner	USA	1
detlef lewe	FRG	2
diana mocanu	ROM	2
diana munz	USA	2
diana munz, julia stowers, lindsay benko, kim black, samantha arsenault, jenny thompson	USA	1
diana paliyska, vanja gesheva-tsvetkova	BUL	1
dick quax	NZL	1
didier hoyer, eric renaud	FRA	1
didier hoyer, olivier boivin	FRA	1
diederik simon, niels van der zwan, nico rienks, koos maasdijk, jeroen duyster, ronald florijn, michiel bartman, henk-jan zwolle, niels van steenis	NED	1
dieter baumann	FRG	1
dieter baumann	GER	1
dieter grahn, frank forberger, dieter schubert, frank r?hle	GDR	1
dieter lindner	GER	1
dieter wendisch, karl-heinz prud?hl, roland kostulski, hans-joachim l?ck, gottfried d?hn, werner klatt, ulrich karnatz, karl-heinz danielowski, bernd baumgart	GDR	1
dimitrie ivanov, haralambie ivanov, anton calenic, mihai turcas	ROM	1
ding chen	CHN	1
dirk crois, pierre-marie deloof	BEL	1
dirk lippits, michiel bartman, diederik simon, jochem verberne	NED	1
dirk richter, steffen zesner, thomas flemming, lars hinneburg	GDR	1
disqualified, usa	NA	1
djan madruga, jorge fernandes, ciro marques delgado, marcus mattioli	BRA	1
djurdica bjedov	YUG	2
dmitry volkov	URS	1
dmitry volkov, vadim yaroshchuk, gennady prigoda, igor polyansky	URS	1
doina ignat, constanta burcica-pipota, georgeta andrunache, eniko barab?s, viorica susanu, rodica serban, simona musat, ioana papuc	ROM	1
doina ignat, georgeta damian	ROM	1
doina ignat, liliana gafencu, elena georgescu, georgeta damian, vera cochelea, maria magdalena dumitrache, elisabeta lipa, ioana olteanu, viorica susanu	ROM	1
doina ignat, vera cochelea, anisoara dobre-balan, constanta burcica-pipota	ROM	1
doina melinte	ROM	2
domenico fioravanti	ITA	2
donald boal, earl eastwood, harry fry, joseph harris, cedric liddell, george macdonald, albert taylor, william thoburn, stanley stanyar	CAN	1
donald finlay	GBR	2
donald lippincott	USA	2
donald mckenzie	USA	1
donald smith, gary macdonald, stephen pickell, clay evans	CAN	1
dongxiang xu, wenyi huang	CHN	1
donna de varona	USA	1
donna de varona, kathleen ellis, sharon stouder, pokey watson	USA	1
donna gurr	CAN	1
donovan bailey	CAN	1
don quarrie	JAM	3
don schollander	USA	3
don thompson	GBR	1
dorian mortelette, benjamin rondeau, germain chardin, julien despr?s	FRA	1
dorothy hyman	GBR	2
dorothy manley	GBR	1
douglas bennett	CAN	1
douglas gjertsen, troy dalbey, matt cetlinski, matt biondi	USA	1
douglas lowe	GBR	2
douglas northway	USA	1
douglas russell	USA	1
douglas wakiihuri	KEN	1
dragos neagu, danut dobre	ROM	1
drew ginn, duncan free	AUS	1
drew ginn, james chapman, joshua dunkley-smith, william lockwood	AUS	1
drew ginn, nicholas green, mike mckay, james tomkins	AUS	1
dudley storey, dick tonks, noel mills, ross collinge	NZL	1
duje draganja	CRO	1
duke kahanamoku	USA	3
duncan armstrong	AUS	2
duncan free, janusz hooker, bo hanson, ron snook	AUS	1
duncan goodhew	GBR	1
duncan white	SRI	1
dwayne evans	USA	1
eamon sullivan	AUS	1
earl eby	USA	1
earl jones	USA	1
earl thomson	CAN	1
eckhard leue	GDR	1
ed coode, james cracknell, steve williams, matthew pinsent	GBR	1
eddie hart, larry black, robert taylor, gerald tinker	USA	1
eddie southern	USA	1
eddie tolan	USA	2
eddy ottoz	ITA	1
edith mcguire	USA	2
ed mckeever	GBR	1
ed moses	USA	1
eduardo guerrero, tranquilo cappozzo	ARG	1
eduardo risso	URU	1
edvin wide	SWE	4
edward lindberg	USA	1
edwin moses	USA	3
edwin roberts	TRI	1
edwin soi	KEN	1
eeke van nes, pieta van dishoeck	NED	1
eero berg	FIN	1
egil s?by, jan johansen, steinar amundsen, tore berger	NOR	1
egil s?by, steinar amundsen, tore berger, jan johansen	NOR	1
egon drews, wilfried soltau	GER	1
eino purje-borg	FIN	1
eirik larsen	NOR	2
eirik veraas larsen	NOR	1
ejigayehu dibaba	ETH	1
ekaterina karsten	BLR	1
ekaterina poistogova	RUS	1
ekaterini thanou	GRE	1
elaine tanner	CAN	2
elaine tanner, marion lay, marilyn corson, angela coughlan	CAN	1
elana meyer	RSA	1
eleanor garatti-saville	USA	2
eleanor holm	USA	1
elena lashmanova	RUS	1
elfi zinn	GDR	1
elia luini, leonardo pettinari	ITA	1
elias katz	FIN	1
elio ragni, orazio mariani, tullio gonnelli, gianni caldana	KIT	1
elisabeta lipa	ROM	1
elisabeta lipa, vera cochelea	ROM	1
elisabeta lipa, vera cochelea, anisoara dobre-balan	ROM	1
elisa rigaudo	ITA	1
elise laverick, anna bebington	GBR	1
eliud kipchoge	KEN	2
elizabeth beisel	USA	2
elizabeth davies	GBR	1
elizabeth mccolgan	GBR	1
elizabeth robinson	USA	1
elizabeth wagstaff, nicole haislett, megan kleine, crissy ahmann-leighton, jenny thompson, summer sanders, anita nall, lea loveless	USA	1
elke sehmisch, gabriele wetzko, kornelia ender, andrea eife	GDR	1
ellen fiedler	GDR	1
ellen king	GBR	1
ellen king, joyce cooper, cissie stewart, vera tanner	GBR	1
ellen streidt	GDR	1
ellen van langen	NED	1
ellie daniel	USA	3
ellie daniel, catie ball, kaye hall, susan pedersen	USA	1
elliott bunney, linford christie, mike mcfarlane, john regis	GBR	1
elodie ouedraogo, hanna marien, olivia borlee, kim gevaert	BEL	1
else jacobsen	DEN	1
elvan abeylegesse	TUR	2
elvira vasilkova	URS	1
emanuele merisi	ITA	1
emanuel silva, fernando piment	POR	1
emiel puttemans	BEL	1
emil breitkreutz	USA	1
emile champion	FRA	1
emilio lunghi	KIT	1
emily seebohm	AUS	1
emily silver, julia smit, dara torres, kara lynn joyce, lacey nymeyer, natalie coughlin	USA	1
emil z?topek	CZE	5
emmanuel bailey	GBR	1
enith brigitha	NED	2
enrique figuerola	CUB	1
enrique figuerola, hermes ramirez, pablo montes, juan morales	CUB	1
eric fish, robert kasting, william mahony, bruce robertson	CAN	1
erich borchmeyer, erwin gillmeister, wilhelm leichum, gerd hornberger	GER	1
erich borchmeyer, helmuth k?rnig, arthur jonath, fritz hendrix	GER	1
erich koschik	GER	1
erich rademacher	GER	1
erick barrondo	GUA	1
erick wainaina	KEN	2
eric liddell	GBR	2
eric murray, hamish bond	NZL	1
eric namesnik	USA	2
eric verdonk	NZL	1
erik backman	SWE	1
erik byl?hn	SWE	1
erik christiansen, lars nielsen, per rasmussen, michael jessen	DEN	1
erik elms?ter	SWE	1
erik hansen	DEN	2
erik vendt	USA	2
erkka wil?n	FIN	1
erminio dones, pietro annoni	KIT	1
ernesto ambrosini	KIT	1
ernesto canto	MEX	1
ernie harper	GBR	1
ernst fast	SWE	1
ernst hoppenberg	DEU	1
ernst schultz	DEN	1
ervin hall	USA	1
erwin sietas	GER	1
erzsebet viski, kinga bota, katalin kovacs, szilvia szabo	HUN	1
eshetu tura	ETH	1
eskild ebbesen, kasper winther, jacob barsoe, morten jorgensen	DEN	1
eskild ebbesen, thomas ebert, victor feddersen, soren madsen	DEN	1
ethelda bleibtrey	USA	1
ethel lackie	USA	1
ethel smith	CAN	1
etienne dagon	SUI	1
etienne gailly	BEL	1
euphrasia donnelly, ethel lackie, gertrude ederle, mariechen wehselau	USA	1
eva-maria ten elsen	GER	1
eva risztov	HUN	1
evelyn ashford	USA	2
evelyn kawamoto	USA	1
evelyn kawamoto, joan alderson, marilee stepan, jacqueline lavine	USA	1
everard butler	CAN	1
evgeny korotyshkin	RUS	1
evgeny lagunov, nikita lobintsev, mikhail polishchuk, danila izotov, alexander sukhorukov	RUS	1
ewa klobukowska	POL	1
ewa klobukowska, halina g?recka-richter, teresa ciepla, irena szewinska	POL	1
ezekiel kemboi	KEN	2
fabien gilot, amaury leveaux, clement lefert, yannick agnel	FRA	1
faith leech	AUS	1
falilat ogunkoya	NGR	1
fani halkia	GRE	1
fanny blankers-koen	NED	2
fanny durack	ANZ	1
fanny rosenfeld	CAN	1
fatuma roba	ETH	1
fay moulton	USA	1
federica pellegrini	ITA	2
felipe m??oz	MEX	1
felix sanchez	DOM	2
ferenc csik	HUN	1
ferenc moh?csi, k?roly wieland	HUN	1
ferenc novak, imre pulai	HUN	1
fermin cacho	ESP	2
fernanda ribeiro	POR	2
fernando scherer	BRA	1
fie udby erichsen	DEN	1
filbert bayi	TAN	1
filippo soffici, alessandro corona, gianluca farina, rossano galtarossa	ITA	1
fita bayissa	ETH	1
fita lovin	ROM	1
florence griffith-joyner	USA	3
florent manaudou	FRA	1
florian schwarthoff	GER	1
florin popescu, mitica pricop	ROM	1
ford konno	USA	2
ford konno, james mclane, wayne moore, william woolsey	USA	1
forrest smithson	USA	1
forrest towns	USA	1
foy draper, ralph metcalfe, jesse owens, frank wykoff	USA	1
francesco cossu, giliante d'este, antonio ghiardello, antonio garzoni provenzani	KIT	1
francesco la macchia, aldo dezzi	ITA	1
frances schroth	USA	1
frances schroth, ethelda bleibtrey, irene guest, margaret woodbridge	USA	1
francine fox, glorianne perrier	USA	1
francis amyot	CAN	1
francisco javier fernandez	ESP	1
francis hegerty, matthew ryan, james marburg, cameron mckenzie-mcharg	AUS	1
francis kerbiriou, gilles bertould, jacques carette, roger v?lasquez	FRA	1
francis lane	USA	1
francis obikwelu	POR	1
franjo mihalic	YUG	1
frank baltrusch	GDR	1
frank baumgartl	GDR	1
frank beaurepaire	ANZ	2
frank beaurepaire	AUS	2
frank beaurepaire, william herald, henry hay, ivan stedman	AUS	1
frank cuhel	USA	1
frank esposito	FRA	1
frank forberger, dieter grahn, dieter schubert, frank r?hle	GDR	1
frank greer	USA	1
frank hansen, svein th?gersen	NOR	1
frankie fredericks	NAM	4
frank jarvis	USA	1
frank loomis	USA	1
frank mckinney	USA	2
frank mckinney, lance larson, jeffrey farrell, paul hait	USA	1
frank pf?tze, detlev grabs, rainer strohbach, j?rg woithe	GDR	1
frank saker, harvey charters	CAN	1
frank schaffer	GDR	1
frank shorter	USA	2
frank waller	USA	2
frank wiegand	GER	1
frank wiegand, roland matthes, eugen henninger, horst-g?nter gregor	GDR	1
franziska van almsick	GER	3
franziska van almsick, hannah stockbauer, antje buschschulte, petra dallmann, janina g?tz	GER	1
franziska van almsick, sandra v?lker, simone osygus, kerstin kielga?, dagmar hase, meike freitag	GER	1
fr?d?ric delcourt	FRA	1
fred deburghgraeve	BEL	1
freddie lane	AUS	1
frederica van der goes, rhoda rennie, kathleen russell, marie bedford	SAF	1
frederick murray	USA	1
frederick pollard	USA	1
frederick schule	USA	1
frederick tyler, mark spitz, john kinsella, steven genter	USA	1
fred holman	GBR	1
fred kelly	USA	1
fred moloney	USA	1
fred newhouse	USA	1
fred newhouse, maxie parks, benjamin brown, herman frazier	USA	1
fred onyancha	KEN	1
fred schmidt	USA	1
fred schmidt, harold mann, steve clark, william craig	USA	1
friedhelm wentzke, berni schulze, g?nter perleberg, holger zander	GER	1
fritz bondroit, ewald tilker	GER	1
fritz hofmann	DEU	1
fritzi schwingl	AUT	1
gabi m?ller, sabine eichenberger, ingrid haralamow, daniela baumer	SUI	1
gabriela szabo	ROM	3
gabriella dorio	ITA	1
gabriella szab?, katalin kov?cs, danuta koz?k, natasa janics	HUN	1
gabriel tiacoh	CIV	1
gail devers	USA	2
gail neall	AUS	1
galen rupp	USA	1
galina alekseyeva-kreft, nina trofimova-gopova	URS	1
galina bukharina, lyudmila samotesova, vera popkova, lyudmila maslakova	URS	1
galina malchugina, lyudmila kondratyeva, natalya pomoshchnikova, marina zhirova	URS	1
galina stepanova-prozumenshchykova	URS	5
gamze bulut	TUR	1
garth manton, michael aikman, adrian monger, harold hewitt, james howden, walter howell, bryan doyle, angus benfield, david boykett	AUS	1
gary chapman	AUS	1
gary dilley	USA	1
gary gullock, paul reedy, anthony lovrich, timothy mclaren	AUS	1
gary hall	USA	3
gary hall jr.	USA	5
gary hall jr., ian crocker, nate dusing, jason lezak, michael phelps, gabe woodward, neil walker	USA	1
gary ilman, don schollander, michael austin, steve clark	USA	1
gary oakes	GBR	1
gaston delaplane	FRA	1
gaston giran, alfred pl?	FRA	1
gaston godel	SUI	1
gaston mercier, yves delacour, guy guillabert, ren? guissart	FRA	1
gaston reiff	BEL	1
gaston roelants	BEL	1
gaston strobino	USA	1
geert jan derksen, gerritjan eggenkamp, jan-willem gabriels, chun wei cheung, michiel bartman, matthijs vellenga, gijs vermeulen, diederik simon, daniel mensch	NED	1
geertje wielema	NED	1
gelindo bordin	ITA	1
gennady bukarin	URS	1
gennady korshikov, aleksandr timoshinin	URS	1
gennady prigoda	URS	1
geoff huegill	AUS	1
geoff stewart, james stewart, ben dodwell, bo hanson	AUS	1
george bovell	TRI	1
george breen	USA	3
george breen, richard hanley, ford konno, william woolsey	USA	1
george bridgewater, nathan twaddle	NZL	1
george dicarlo	USA	2
george dietz, august erker, albert nasse, arthur stockhoff	USA	1
george harrison, richard blick, jeffrey farrell, michael troy	USA	1
george hodgson	CAN	2
george hungerford, roger jackson	CAN	1
george hutson	GBR	1
george kerr	BWI	1
george kerr, keith gardner, james wedderburn, malcolm spence	BWI	1
george kojac	USA	1
george mackay, archibald black, colin finlayson, william wood	CAN	1
george nash, william satch	GBR	1
george orton	CAN	1
george poage	USA	1
george rhoden	JAM	1
george rhoden, arthur wint, herb mckenley, leslie laing	JAM	1
george saling	USA	1
georges dransart, georges gandil	FRA	1
george simpson	USA	1
georges piot, maurice bouton	FRA	1
georges vallerey	FRA	1
georgeta damian, viorica susanu	ROM	1
george vernot	CAN	2
george young	USA	1
georgina bardach	ARG	1
georg lammers	GER	1
georgy prokopenko	URS	1
gerald ashworth, paul drayton, bob hayes, richard stebbins	USA	1
gerard nijboer	NED	1
gerhard boetzelen, herbert buhtz	GER	1
gerhard hennige	FRG	1
gerhard hetz	GER	1
gerhard hetz, hans-joachim klein, uwe jacobsen, horst-g?nter gregor, frank wiegand	GER	1
germain chardin, dorian mortelette	FRA	1
gert fredriksson	SWE	4
gert fredriksson, sven-olof sj?delius	SWE	1
gertrude ederle	USA	2
gertrude liebhart	AUT	1
gete wami	ETH	3
gezahgne abera	ETH	1
gheorghe simionov, gheorghe danilov	ROM	1
giancarlo crosta, renato bosatta, tullio baraglia, giuseppe galante	ITA	1
gilbert bozon	FRA	1
giovanni calabrese, nicola sartori	ITA	1
giovanni de benedictis	ITA	1
gisela arendt	GER	1
giuseppe moioli, elio morille, giovanni invernizzi, franco faggi	ITA	1
giuseppina leone	ITA	1
gladys carson	GBR	1
glen housman	AUS	1
glenn beringen	AUS	1
glenn buchanan	SUR	1
glenn cunningham	USA	1
glenn davis	USA	2
glenn davis, otis davis, jack yerman, earl young	USA	1
glenn hardin	USA	2
glenroy gilbert, robert esmie, donovan bailey, bruny surin	CAN	1
gloria siebert	GDR	1
glory alozie	NGR	1
?gnes kov?cs	HUN	2
g?nther pfaff, gerhard seibold	AUT	1
godfrey brown	GBR	1
godfrey brown, godfrey rampling, william roberts, freddie wolff	GBR	1
gordon pirie	GBR	1
gottfried kottmann	SUI	1
grace jackson	JAM	1
graeme brewer	AUS	1
graeme smith	GBR	1
graham windeatt	AUS	1
g?ran larsson	SWE	1
grant davies	AUS	1
grant hackett	AUS	4
grant hackett, michael klim, todd pearson, antony matkovich, nicholas sprenger, craig stevens, ian thorpe	AUS	1
grant hackett, nick ffrost, leith brodie, grant brits, patrick murphy, kirk palmer	AUS	1
grantley goulding	GBR	1
g?rard blitz	BEL	1
gratsian botev, pavel kharin	URS	1
greg barton	USA	3
greg barton, norman bellingham	USA	1
greg foster	USA	1
greg haughton	JAM	1
gregor hradetzky	AUT	1
gregory brough	AUS	1
gregory buckingham	USA	1
gregory burgess	USA	1
gregory fasala, michael delany, neil brooks, mark stockwell	AUS	1
gregory rogers, robert windle, graham white, michael wenden	AUS	1
greta andersen	DEN	1
greta andersen, fritze carstensen-nathansen, karen harup, eva riise-arndt	DEN	1
grete waitz	NOR	1
grigore obreja, gheorghe andriev	ROM	1
grzegorz kotowicz, dariusz bialkowski	POL	1
g?te hagstr?m	SWE	1
guanliang meng, wenjun yang	CHN	1
gudrun beckmann, jutta weber, heidemarie reineck, angela steinbach	FRG	1
gudrun wegner	GDR	1
guillaume leblanc	CAN	1
guillermo del riego, herminio men?ndez	ESP	1
guillermo douglas	URU	1
gunhild hoffmeister	GDR	3
gunnar h?ckert	FIN	1
gunnar larsson	SWE	2
gunnar olsson, karl sundqvist	SWE	1
gunnar utterberg, sven-olof sj?delius	SWE	1
gustav jansson	SWE	1
gustavo fran?a borges	BRA	3
gustavo fran?a borges, carlos jayme, fernando scherer, edvaldo silva filho	BRA	1
gustav sch?fer	GER	1
guy butler	GBR	2
guy butler, edward toms, george renwick, richard ripley, cecil griffiths, robert lindsay, john ainsworth-davis, guy butler	GBR	1
guy drut	FRA	2
gwendoline porter, eileen hiscock, nellie halstead, violet webb	GBR	1
gwen torrence	USA	2
gwen torrence, carlette guidry, esther jones, evelyn ashford	USA	1
gyorgy kozmann, gy?rgy kolonics	HUN	1
gy?rgy kolonics	HUN	1
gy?rgy mitr?	HUN	1
gy?rgy mitr?, imre ny?ki, g?za k?das, elem?r szathm?ry	HUN	1
gy?rgy m?sz?ros, andr?s szente	HUN	1
gy?rgy sarl?s, antal melis, zolt?n melis, j?zsef csermely	HUN	1
gy?rgy tumpek	HUN	1
gy?rgy zala	HUN	2
gyula kellner	HUN	1
gyula petrikovics, tam?s wichmann	HUN	1
g?za csap?	HUN	2
g?za k?das	HUN	1
habiba ghribi	TUN	1
hadi souan somayli	KSA	1
haile gebrselassie	ETH	2
haley anderson	USA	1
halimat ismaila, franca idoko, gloria kemasuode, oludamola osayomi, agnes osazuwa	NGR	1
halina g?recka-richter, teresa ciepla, barbara janiszewska, celina jesionowska	POL	1
hannelore anke	GDR	1
hannes kolehmainen	FIN	3
hanns braun	DEU	2
hanny termeulen	NED	1
hanny termeulen, koosje van voorn, marie-louise linssen-vaessen, irma heijting-schuhmacher	NED	1
hans berglund, lennart klingstr?m	SWE	1
hans dam	DEN	1
hans fa?nacht, werner lampe, hans-g?nter vosseler, klaus steinbach	FRG	1
hans-georg reimann	GDR	2
hans grodotzki	GER	2
hans-joachim hannemann, heinz kaufmann, hans kuschke, herbert schmidt, werner loeckle, wilhelm mahlow, helmut radach, alfred rieck, gerd v?ls	GER	1
hans-joachim klein	GER	1
hans-joachim klein, horst l?ffler, frank wiegand	GER	1
hansj?rg kunze	GDR	1
hans kalt, josef kalt	SUI	1
hans kalt, kurt schmid	SUI	1
hansle parchment	JAM	1
hans magnus grepperud, sverre l?ken	NOR	1
hans maier, karl aletter, walter flinsch, ernst gaber	GER	1
hanson, viinberg, guloien, wilkinson, mastracci, brzozowicz, marquardt, morin, thompson-willie	CAN	1
hans sennewald, thorsten streppelhoff, bahne rabe, frank richter, detlef kirchhoff, manfred klein, armin eichholz, roland baar, ansgar wessling	GER	1
hans walter, emile albrecht, alfred probst, eugen sigg-b?chthold	SUI	1
harald julin	SWE	1
harald norpoth	GER	1
harald schmid	FRG	1
harald schmid, lothar krieg, bernd herrmann, franz-peter hofmeister	FRG	1
harold abrahams	GBR	1
harold barker, john fenning, philip filleul, gordon thomson, albertus wielsma, geoffrey taylor, hermanus h?fte, charles riddy, becher robert gale, bernardus croon, gordon balfour, johan burk	NED	1
harold barron	USA	1
harold hardwick	ANZ	2
harold west, arthur sulley, guy nickalls, gordon killick, harold lane, jack beresford, john badcock, donald gollan, james hamilton	GBR	1
harold whitlock	GBR	1
harold wilson	GBR	1
harrison dillard	USA	2
harrison dillard, barney ewell, melvin patton, lorenzo wright	USA	1
harrison dillard, lindy remigino, andy stanfield, dean smith	USA	1
harry blackstaffe	GBR	1
harry davel, bevil rudd, clarence oldfield, jack oosterlaak	SAF	1
harry edward	GBR	2
harry hebner	USA	1
harry hebner, ken huszagh, perry mcgillivray, duke kahanamoku	USA	1
harry hillman	USA	3
harry jerome	CAN	1
harry larva	FIN	1
harry lott, frank schell, louis abell, michael gleason, john exley, james flanagan, frederick cresser, joseph dempsey, charles armstrong	USA	1
hartwig gauder	GDR	2
harvey glance, millard hampton, john jones, steven riddick	USA	1
hasely crawford	TRI	1
hasna benhassi	MAR	2
hassiba boulmerka	ALG	1
hayden stoeckel	AUS	1
hayes jones	USA	2
hayley lewis	AUS	2
heather armitage, june foulds-paul, anne pashley, jean scrivens	GBR	1
heather hunte, sonia lannaman, beverley goddard-callender, kathryn smallwood-cook	GBR	1
heather stanning, helen glover	GBR	1
hec hogan	AUS	1
heidemarie reineck, silke pielen, gudrun beckmann, vreni eberle	FRG	1
heidemarie reineck, uta frommater, angelika kraus, heike hustede	FRG	1
heide rosendahl, annegret richter, christiane krause, ingrid mickler-becker	FRG	1
heike d?hne	GDR	1
heike drechsler	GDR	2
heike friedrich	GDR	2
heike schulte-mattler, ute thimm, heide-elke gaugel, gaby bu?mann	FRG	1
heini thoma, rudolf bosshard	SUI	1
heinz b?ker, holger zander	GER	1
heinz ulzheimer	GER	1
heinz ulzheimer, g?nther steines, hans geister, karl-friedrich haas	GER	1
helene madison	USA	2
helen gordon	GBR	1
helen johns, eleanor garatti-saville, helene madison, josephine mckim	USA	1
helen stephens	USA	1
helen stephens, annette rogers, elizabeth robinson, harriet bland	USA	1
helen varcoe, edna hughes, joyce cooper, elizabeth davies	GBR	1
helen wainwright	USA	1
helga klein, ursula knab, marie sander, marga petersen	GER	1
helga lindner	GDR	1
helge halkj?r, aksel hansen, ib storm larsen, helge schr?der	DEN	1
helmut c?mmerer	GER	1
helmuth k?rnig	GER	1
henk-jan zwolle, nico rienks	NED	1
henning jakobsen	DEN	2
henri barrelet	FRA	1
henri deloge	FRA	1
henri eberhardt	FRA	1
henri jan wienese	NED	1
henrik nilsson, markus oscarsson	SWE	2
henri tauzin	FRA	1
henry carr	USA	1
henry eriksson	SWE	1
henry jonsson	SWE	1
henry stallard	GBR	1
henry taylor	GBR	4
henry taylor, edward peter, harold annison, leslie savage	GBR	1
herb elliott	AUS	1
herbert haresnape	GBR	1
herbert jamison	USA	1
herbert klein	GER	1
herbert schade	GER	1
herb mckenley	JAM	3
herman frazier	USA	1
herman groman	USA	1
hermann betschart, hans homberger, alex homberger, karl schmid	SUI	1
hermann engelhard	GER	1
hermann engelhard, otto neumann, richard krebs, harry storz	GER	1
hermine stindt, louise otto, grete rosenberg, vally dressel	DEU	1
herminio men?ndez, luis miguez	ESP	1
hezekiah nyamau, daniel rudisha, charles asati, naftali bon	KEN	1
hezekiel sepeng	RSA	1
hicham el guerrouj	MAR	3
hideko maehata	JPN	2
hilda strike	CAN	1
hilda strike, mary frizzel, mildred frizzel, lillian palmer	CAN	1
hildegard falck	FRG	1
hilde lauer	ROM	1
hilde schrader	GER	1
hiroshi suzuki	JPN	1
hisayoshi sato, junichi miyashita, kosuke kitajima, takuro fujii	JPN	1
h?kan malmroth	SWE	1
hong qian	CHN	2
horace ashenfelter	USA	1
horacio podest?, julio curatella	ARG	1
horatio fitch	USA	1
horst-g?nter gregor, eugen henninger, hans-joachim klein, ernst-joachim k?ppers	GER	1
howard valentine	USA	1
huali lu, xiaoli gu	CHN	1
hugh edwards, jack beresford, john badcock, roland george	GBR	1
hugh fisher, alwyn morris	CAN	1
hugo kusick	EST	1
hugo strau?, willi eichhorn	GER	1
hugues duboscq	FRA	3
huina xing	CHN	1
ian crocker	USA	1
ian crocker, brendan hansen, mark gangloff, jason lezak, lenny krayzelburg, aaron peirsol, michael phelps, neil walker	USA	1
ian ferguson	NZL	1
ian ferguson, grant bramwell, paul macdonald, alan thompson	NZL	1
ian ferguson, paul macdonald	NZL	2
ian o'brien	AUS	1
ian o'brien, david dickson, kevin berry, peter reynolds	AUS	1
ian stewart	GBR	1
ian thorpe	AUS	5
ian thorpe, todd pearson, daniel kowalski, michael klim, william kirby, grant hackett	AUS	1
ian wynne	GBR	1
ib ivan larsen, peter christiansen	DEN	1
ibrahim rojas, ledys frank balceiro	CUB	1
igor buldakov, viktor ivanov	URS	1
igor francetic, tihomir frankovic, igor boraska, kresimir culjak, branimir vujevic, niksa skelin, sinisa skelin, tomislav smoljanovic, silvijo petrisko	CRO	1
igor pisarev	URS	1
igor polyansky	URS	2
igor yemchuk, georgy zhilin	URS	1
ileana silai	ROM	1
ilmari salminen	FIN	1
ilse kaschube, petra grabowski	GDR	1
ilya markov	RUS	1
imre farkas, andr?s istv?n t?r?	HUN	1
imre pulai	HUN	1
imre sz?ll?si	HUN	1
imre sz?ll?si, csaba giczi, istv?n csizmadia, istv?n tim?r	HUN	1
ina beyermann	FRG	1
ina beyermann, ute hasse, karin seick, svenja schlicht	FRG	1
ina kleber	GDR	1
ines diers	GDR	4
ines diers, sarina h?lsenbeck, barbara krause, caren metschuck	GDR	1
ines gei?ler	GDR	1
inga gentzel	SWE	1
inge de bruijn	NED	6
inge dekker, femke heemskerk, ranomi kromowidjojo, manon van rooijen, marleen veldhuis, hinkelien schreuder	NED	1
inge dekker, marleen veldhuis, femke heemskerk, ranomi kromowidjojo	NED	1
inge helten	FRG	1
inge helten, annegret kroninger, annegret richter, elvira po?ekel	FRG	1
inge s?rensen	DEN	1
ingo spelly, olaf heukrodt	GDR	1
ingo spelly, ulrich papke	GER	1
ingrid lange-auerswald	GDR	1
ingrid lange-auerswald, marlies g?hr-oelsner, romy m?ller, b?rbel w?ckel-eckert	GDR	1
ingrid lempereur	BEL	1
ingrid schmidt, b?rbel fuhrmann, ursula brunner, ursula k?per	GER	1
ingvar pettersson	SWE	1
inna frolova, antonina dumcheva, irina kalimbet, svetlana mazy	URS	1
inna frolova, olena ronzhina, diana miftakhutdinova, svetlana mazy	UKR	1
inna osypenko	UKR	3
innocent egbunike, rotimi peters, moses ugbusie, sunday uti	NGR	1
ion birladeanu	ROM	1
ionela tirlea-manolache	ROM	1
ira davenport	USA	1
irena szewinska	POL	5
irene eijs, eeke van nes	NED	1
irene guest	USA	1
irina nazarova, tatyana prorochenko, tatyana goyshchik, nina zyuskova	URS	1
irina privalova	RUS	1
irina privalova	URS	1
irnya lishchynska	UKR	1
isabella ochichi	KEN	1
ismail ahmedismail	SUD	1
istv?n b?r?ny	HUN	1
istv?n b?r?ny, l?szl? szabados, andr?s sz?kely, andr?s wani?	HUN	1
istv?n hernek	HUN	1
istv?n jo?s, istv?n szab?	HUN	1
istv?n r?zsav?lgyi	HUN	1
iuliia efimova	RUS	1
ivan belyaev	URS	1
ivan burchin, fedya damyanov	BUL	1
ivan garcia, jose angel cesar, luis alberto perez, freddy mayola	CUB	1
ivano brugnetti	ITA	1
ivan patzaichin	ROM	1
ivan patzaichin, petre capusta	ROM	1
ivan patzaichin, serghei covaliov	ROM	1
ivan patzaichin, toma simionov	ROM	3
ivan riley	USA	1
ivan shtyl	RUS	1
ivans klementjevs	LAT	2
ivans klementjevs	URS	1
ivar stukolkin	URS	1
ivar stukolkin, vladimir salnikov, andrey krylov, sergey koplyakov	URS	1
ivo van damme	BEL	2
ivo yanakiev	BUL	1
izabella dylewska	POL	2
iztok cop, denis zvegelj	SLO	1
iztok cop, luka spik	SLO	3
jaap kraaier	NED	1
jack babashoff	USA	1
jack beresford	GBR	2
jack beresford, dick southwood	GBR	1
jack davis	USA	2
jack dearlove, chris barton, ernest bircher, maurice lapage, guy richardson, charles lloyd, paul massey, alfred mellows, david meyrick	GBR	1
jack guest, joseph wright	CAN	1
jack hand, john donnelly, frank fiddes, frederick hedges, jack murdock, athol meech, cyril norris, william ross, herbert richardson	CAN	1
jack horsley	USA	1
jack jarvis	GBR	2
jack kelly	USA	1
jack kelly, paul costello	USA	2
jack london	GBR	1
jack lovelock	NZL	1
jack medica	USA	2
jack pierce	USA	1
jackson scholz	USA	2
jack taylor	USA	1
jacob clear, david smith, tate smith, murray stewart	AUS	1
jacob jensen, ejvind hansen	DEN	1
jake wetzel, barney williams, cameron baerg, thomas herschmiller	CAN	1
james ball	CAN	1
james cristy	USA	1
james gathers	USA	1
james godday, musa audu, saul weigopwa, enefiok udo-obong	NGR	1
james juvenal	USA	1
james lightbody	USA	5
james luvalle	USA	1
james magnussen	AUS	1
james mcintosh, arthur mckinlay, john mckinlay, john welchli	USA	1
james mclane	USA	2
james rector	USA	1
james soutter, cyril seedhouse, george nicol, ernest henley	GBR	1
james thompson, john smith, sizwe ndlovu, matthew brittain	RSA	1
james thompson, walter spence, garnet ault, frederik bourne	CAN	1
james tomkins, drew ginn	AUS	1
james wendell	USA	1
james wilson	GBR	1
jana henke	GER	1
jana sorgers, katrin rutschow-stomporowski, kathrin boron, kerstin k?ppen	GER	1
jana thieme, kathrin boron	GER	1
jan brz?k-felix, bohumil kudrna	CZE	2
jan brz?k-felix, vladim?r syrov?tka	CZE	1
jane barkman	USA	1
jane cederqvist	SWE	1
janeene vickers	USA	1
janel jorgensen, beth barr, tracey mcfarlane, mary wayte	USA	1
jane saville	AUS	1
jane swagerty	USA	1
janet evans	USA	5
janeth busienei	KEN	1
jan henne	USA	3
janice andrew	AUS	1
janice andrew, dawn fraser, marilyn wilson, rosemary lassig	AUS	1
jani sievinen	FIN	1
janusz kusocieski	POL	1
janusz mikolajczak, henryk budzinski	POL	1
jaouad gharib	MAR	1
jared tallent	AUS	3
jarmila kratochv?lov?	CZE	1
jason lezak	USA	1
jason lezak, gary hall jr., anthony ervin, josh davis, neil walker, scott tucker	USA	1
jason lezak, michael phelps, nathan adrian, matt grevers, cullen jones, benjamin wildman-tobriner, garrett weber-gale	USA	1
jason read, bryan volpenhein, chris ahrens, wyatt allen, dan beery, pete cipollone, matt deakin, joseph hansen, beau hoopman	USA	1
jason richardson	USA	1
javier culson	PUR	1
jean boiteux	FRA	1
jean bouin	FRA	1
jean-christophe rolland, michel andrieux	FRA	1
jeannette campbell	ARG	1
jean stewart	NZL	1
jean taris	FRA	1
jearl miles, marion jones, monique hennagan, latasha colander-richardson	USA	1
jearl miles, natasha kaiser, rochelle stevens, gwen torrence	USA	1
jed graef	USA	1
jefferson perez	ECU	1
jefferson p?rez	ECU	1
jeff rouse	USA	2
jelisaveta dementyeva	URS	1
jenna johnson	USA	1
jennie fletcher	GBR	1
jennie fletcher, isabella moore, annie speirs, irene steer	GBR	1
jennifer lamy	AUS	1
jennifer stoute, phylis smith, sandra douglas, sally gunnell	GBR	1
jenny maakal	SAF	1
jenny thompson	USA	1
jenny thompson, amanda weir, kara lynn joyce, tara kirk, natalie coughlin, haley cope, amanda beard, rachel komisarz	USA	1
jens kruppa, stev theloke, torsten spanneberg, thomas rupprath	GER	1
jens-peter herold	GDR	1
jeremy linn	USA	1
jeremy wariner	USA	2
jeremy wariner, angella taylor, reggie witherspoon, kerron clement, dave neville, lashawn merritt	USA	1
jerry heidenreich	USA	2
jerry heidenreich, david edgar, john murphy, mark spitz	USA	1
jerzy ustupski, roger verey	POL	1
jesse mashburn, tom courtney, lou jones, charles jenkins	USA	1
jesse owens	USA	2
jessica hardy, allison schmitt, missy franklin, lia neal	USA	1
jessicah schipper	AUS	2
jessica monroe, heather mcdermid, maria maunder, emma robinson, lesley thompson, tosha tsang, anna van der kamp, theresa luke, alison korn	CAN	1
jessica monroe, marnie mcbean, brenda taylor, lesley thompson, kay worthington, kathleen heddle, megan delehanty, shannon crawford, kirsten barnes	CAN	1
jevgenij shuklin	LTU	1
jiao liuyang	CHN	1
ji li, jiaying pang, yu yang, yanwei xu, yingwen zhu	CHN	1
jill sterkel	USA	1
jill sterkel, wendy boglioli, shirley babashoff, kim peyton	USA	1
jim fifer, duvall hecht	USA	1
jim hines	USA	1
jim montgomery	USA	2
jimmy tremeer	GBR	1
jim ryun	USA	1
jingyi le	CHN	2
jingyi le, yun nian, ying shan, na chao	CHN	1
j?nis dalins	LAT	1
j?nos parti	HUN	2
joachim b?chner	GER	1
joachim b?hmer, hans-ullrich schmied	GDR	1
joachim dreifke	GDR	1
joachim ehrig, peter funnek?tter, franz held, wolfgang plottke	FRG	1
joachim mattern, bernd olbricht	GDR	1
joachim pirsch, willi kaidel	GER	1
joan benoit	USA	1
joan harrison	SAF	1
joanna hayes	USA	1
joanne jackson	GBR	1
joaquim cruz	BRA	2
jocelyn delecour, paul genevay, bernard laidebeur, claude piquemal	FRA	1
jochen mei?ner	FRG	1
jochen reske, manfred kinder, johannes kaiser, carl kaufmann	GER	1
jodie henry	AUS	1
jodie henry, sarah ryan, petria thomas, lisbeth lenton, alice mills	AUS	1
joe deloach	USA	1
joe forshaw	USA	1
joe hudepohl, douglas gjertsen, scott jaffe, daniel jorgensen, melvin stewart, jon olsen	USA	1
joel lamela, andr?s sim?n, joel isasi, jorge aguilera	CUB	1
joel sanchez	MEX	1
joel shankle	USA	1
johan andersen	DEN	1
johan kenkhuis, pieter van den hoogenband, marcel wouda, mark van der zijden, martijn zuijdweg	NED	1
johanna klier-schaller	GDR	2
johannes drost	NED	1
johannes van dijk, henrikus tromp, hendrik offerhaus, walter middelberg, walter thijssen, ruud leegstra, roelof klein, hermanus brockmann, fran?oise brandt	NED	1
john akii-bua	UGA	1
john archer, john gregory, kenneth jones, alistair mccorquodale	GBR	1
john bray	USA	1
john campbell, sebastian earl, robin johnstone, richard lucas, walter james, ewart horsfall, ralph shove, guy nickalls, sidney swann	GBR	1
john carlos	USA	1
john collier	USA	1
john cooper	GBR	1
john cooper, robbie brightwell, timothy graham, adrian metcalfe	GBR	1
john cornes	GBR	1
john cregan	USA	1
john daly	GBR	1
john davies	AUS	1
john davies	NZL	1
john devitt	AUS	2
john disley	GBR	1
john fenning, gordon thomson	GBR	1
john ferris	USA	2
john garrels	USA	1
john hatfield	GBR	2
john hatfield, william foster, thomas battersby, henry taylor	GBR	1
john hayes	USA	1
john hencken	USA	4
john hencken, jim montgomery, john naber, matt vogel	USA	1
john hoben, james mcloughlin, john wells, joseph ravanack	USA	1
john holland	NZL	1
john hunter, tony hurt, dick joyce, trevor coker, simon dickie, athol earl, gary robertson, wybo veldman, lindsay wilson	NZL	1
john kelly	USA	1
john kinsella	USA	1
john konrads	AUS	2
john konrads, john devitt, david dickson, murray rose	AUS	1
john landy	AUS	1
john lecky, lorne loomer, william mckerlich, archibald mckinnon, glen mervyn, nelson kuhn, ignace d'hondt, sohen biln, donald arnold	CAN	1
john ljunggren	SWE	3
john loaring	CAN	1
john marshall	AUS	2
john mcgough	GBR	1
john mclean	USA	1
john mockton, doug hamilton, bruce ford, mike hughes	CAN	1
john monckton	AUS	1
john mulcahy, william varley, john joachim, john buerger	USA	1
john murphy	USA	1
john mykkanen	USA	1
john naber	USA	3
john naber, jim montgomery, bruce furniss, mike bruner	USA	1
john nelson	USA	2
john ngugi	KEN	1
john norton	USA	1
johnny gray	USA	1
johnny weissmuller	USA	3
johnny weissmuller, walter laufer, george kojac, austin clapp	USA	1
john russell, ted nash, john james, william barry, hugh wardell-yerburgh	GBR	1
john schmitt, paul mcdowell	USA	1
john sherwood	GBR	1
john smith, warren snyder, norman taylor, harold little, arthur bell, ivor campbell, william langford, robert hunter, william wallace	CAN	1
john somers-smith, angus gillan, duncan mackinnon, collier cudmore	GBR	1
john s?rensen, peer nielsen	DEN	1
john sumegi	AUS	1
john svanberg	SWE	1
john terwilliger, andrew sudduth, christopher penny, walter lubsen, robert jaugstetter, charles clapp, thomas darling, earl borchelt, bruce ibbetson	USA	1
john treacy	IRL	1
john walker	NZL	1
john wallace, bruce robertson, michael rascher, derek porter, terrence paul, robert marland, mike forgeron, andrew crosby, darren barber	CAN	1
john wood	CAN	1
john woodruff	USA	1
jolanda ceplak	SLO	1
jolanda de rover	NED	2
jo?l bettin, philippe renaud	FRA	1
jonathan smith, philip stekl, alan forney, david clark	USA	1
jon drummond, maurice greene, brian lewis, bernard williams iii	USA	1
jon drummond, tim harden, mike marsh, dennis mitchell	USA	1
jon henricks	AUS	1
jon olsen, brad schumacher, joe hudepohl, josh davis, ryan berube	USA	1
jon olsen, matt biondi, joe hudepohl, thomas jager, shaun jordan	USA	1
jon olsen, pablo morales, melvin stewart, melvin stewart, jeff rouse, nelson diebel, hans dersch, hans dersch, david berkoff, david berkoff, matt biondi, matt biondi	USA	1
jon sieben	AUS	1
jopie selbach, tini wagner, willie den ouden, rie mastenbroek	NED	1
jorge llopart	ESP	1
jos? abascal	ESP	1
josefa idem	ITA	1
josefa idem, barbara sch?ttpelz	FRG	1
josefa idem guerrini	ITA	3
josef dolezal	CZE	1
josef dostal, daniel havel, jan sterba, lukas trefil	CZE	1
josef hasen?hrl	AUT	1
josef holecek	CZE	2
josef kloimstein, alfred sageder	AUT	1
josef odlozil	CZE	1
josef schneider	SUI	1
joseph bottom	USA	1
joseph de combe	BEL	1
joseph guillemot	FRA	2
josephine mckim	USA	1
joseph keter	KEN	1
joseph larran	FRA	1
joseph mahmoud	FRA	1
joseph mccluskey	USA	1
joseph ryan, robert farnam	USA	1
joseph verdeur	USA	1
josh culbreath	USA	1
josia thugwane	RSA	1
jos? l?pez, herminio men?ndez, luis miguez, jos? esteban	ESP	1
jos? pedraza	MEX	1
josy barthel	LUX	1
joyce chepchumba	KEN	1
joyce cooper	GBR	2
jozef pribilinec	CZE	1
j?rgen bertow, hans-ullrich schmied	GDR	1
j?rgen eschert	GER	1
j?rgen straub	GDR	1
j?rg hoffmann	GER	1
j?rg lucke, heinz-j?rgen bothe	GDR	1
j?rg pfeifer, alexander thieme, manfred kokot, klaus-dieter kurrat	GDR	1
j?rg schmidt	GDR	1
j?rg woithe	GDR	1
j?ri jaanson	EST	1
j?ri lossmann	EST	1
juan carlos zabala	ARG	1
juan rodriguez, william jones	URU	1
judi brown	USA	1
judith amoore	AUS	1
judit temes	HUN	1
judy davies	AUS	1
judy grinham	GBR	1
judy playfair, lynette mcclements, janet steinbeck, lynette watson	AUS	1
jules de bisschop, oscar decock, prosp?re bruggeman, maurice hemelsoet, oscar charles de somville, frank odberg, marcel lucien van crombrugge, alfred vanlandeghem, maurice verdonck	BEL	1
jules ladoum?gue	FRA	1
julia greville, emma johnson, susan o'neill, lise mackie, nicole stevenson	AUS	1
julia michalska, magdalena fularczyk	POL	1
julie mcdonald	AUS	1
juliet cuthbert	JAM	2
juliet cuthbert, michelle freeman, nikole mitchell, merlene ottey-page	JAM	1
juliette haigh, rebecca scown	NZL	1
julius kariuki	KEN	1
julius korir	KEN	1
julius sang	KEN	1
june croft	GBR	1
june croft, ann osgerby, margaret kelly, helen jameson	GBR	1
june foulds-paul, jean desforges, sylvia cheeseman, heather armitage	GBR	1
june maston, betty mckinnon, joyce king, shirley strickland	AUS	1
junxia wang	CHN	2
juraj tarr, michal riszdorfer, richard riszdorfer, erik vlcek	SLO	1
juris silovs, aleksandr kornelyuk, vladimir lovetsky, valery borzov	URS	1
justin gatlin	USA	3
justin lemberg	AUS	1
justin norris	AUS	1
justus smith, john stack, ralph purchase, david turner, ian turner, james hardy, george ahlgren, david brown, lloyd butler	USA	1
jutta behrendt	GDR	1
jutta heine	GER	1
j?zsef deme, j?nos r?tkai	HUN	1
j?zsef kov?cs	HUN	1
j?zsef szab?	HUN	1
kaarlo maaninka	FIN	2
kaitlin sandeno	USA	3
kajetan broniewski	POL	1
kalle tuominen	FIN	1
karel lismont	BEL	2
karen harup	DEN	2
karen hoff	DEN	1
karen moe	USA	1
karen moras	AUS	1
karen phillips	AUS	1
karin balzer	GDR	1
karin nilsson, emy machnow, jane gylling, aina berg	SWE	1
karin seick	FRG	1
karl-friedrich haas	GER	1
karl-heinrich von groddeck, hans-j?rgen wallbrecht, klaus aeffke, thomas ahrens, klaus behrens, klaus bittner, j?rgen schroeder, j?rgen plagemann, horst meyer	GER	1
karl-heinrich von groddeck, klaus bittner, karl-heinz hopp, hans lenk, willi padge, frank schepke, kraft schepke, manfred rulffs, walter schr?der	GER	1
karl ruberl	AUT	2
karl warner, bill carr, edgar ablowich, ivan fuqua	USA	1
karsten forsterling, james mcrae, daniel noonan, christopher morgan	AUS	1
katalin kovacs, danuta kozak, gabriella timea szabo, krisztina fazekas	HUN	1
katalin kovacs, natasa janic	HUN	1
katalin sz?ke	HUN	1
katharine merry	GBR	1
katherine copeland, sophie hosking	GBR	1
katherine grainger, anna watkins	GBR	1
katherine grainger, guin batten, miriam batten, gillian lindsay	GBR	1
kathleen ellis	USA	2
kathleen heddle, marnie mcbean	CAN	1
kathleen nord	GDR	1
kathrin boron, manuela lutze, britta oppelt, stephanie schiller	GER	1
kathrin d?rre	GDR	1
kathrin mei?ner	GDR	1
kathrin zimmermann	GDR	1
kathryn smallwood-cook	GBR	1
kathryn smallwood-cook, simmone jacobs, beverley goddard-callender, heather hunte	GBR	1
kathy hammond	USA	1
katie hoff	USA	2
katie ledecky	USA	1
katrin borchert	AUS	1
katrin borchert, anna wood	AUS	1
katrin borchert, birgit fischer, anke nothnagel-von seck, ramona portwich	GER	1
katrin rutschow-stomporowski	GER	2
katrin wagner	GER	1
katsuo takaishi	JPN	1
kay bluhm, torsten gutsche	GER	3
kaye hall	USA	2
kazimierz zimny	POL	1
kazuo tomita, keigo shimizu, yoshihiko osaki, koichi hirakida	JPN	1
kee-chung sohn	JPN	1
keena rothhammer	USA	2
keith carter	USA	1
kellie wells	USA	1
kelly holmes	GBR	3
kelvin graham, peter foster	AUS	1
kelvin graham, ramon andersson, ian rowling, steven wood	AUS	1
kenenisa bekele	ETH	4
ken huszagh	USA	1
kenji kimihara	JPN	1
ken matthews	GBR	1
kennedy mcarthur	SAF	1
kenneth myers	USA	1
kenneth walsh	USA	1
kentaro kawatsu	JPN	1
ken wallace	AUS	2
kerron clement	USA	1
kerron stewart	JAM	2
kerstin behrendt, marlies g?hr-oelsner, ingrid lange-auerswald, silke m?ller-gladisch	GDR	1
kerstin kielga?	GER	1
kerstin k?ppen, kathrin boron	GER	1
kerstin m?ller, kristina mundt, birgit peter, sybille schmidt	GER	1
kevan gosper, leon gregory, david lean, graham gipson	AUS	1
kevin berry	AUS	1
kevin young	USA	1
khalid boulami	MAR	1
khalid skah	MAR	1
kharis yunichev	URS	1
kieren perkins	AUS	4
kiki caron	FRA	1
kim batten	USA	1
kim crow	AUS	1
kim crow, brooke pratley	AUS	1
kim gallagher	USA	2
kim knudsen, rene poulsen	DEN	1
kim turner	USA	1
kim vandenberg, julia smit, allison schmitt, christine marshall, katie hoff, caroline burckle, natalie coughlin	USA	1
kinue hitomi	JPN	1
kipchoge keino	KEN	4
kipkemboi kimeli	KEN	1
kirani james	GRN	1
kirk baptiste	USA	1
kirsten emmelmann, sabine busch, petra m?ller, dagmar neubauer-r?bsam	GDR	1
kirsten thomson, jacinta van lint, elka graham, petria thomas, susan o'neill, giaan rooney	AUS	1
kirsten van der kolk, marit van eupen	NED	2
kirsten vlieghuis	NED	2
kirsty conventry	ZIM	3
kirsty coventry	ZIM	4
kjersti plaetzer	NOR	1
kjersti platzer	NOR	1
kjetil undset, steffen st?rseth	NOR	1
klaus ehl, jobst hirscht, karlheinz klotz, gerhard wucherer	FRG	1
klaus kr?ppelien, joachim dreifke	GDR	1
klaus-peter hildenbrand	FRG	1
klaus richtzenhain	GER	1
klaus thiele, frank schaffer, volker beck, andreas knebel	GDR	1
klemie bimolt, ada kok, erica terpstra, korrie winkel	NED	1
klete keller	USA	2
kl?ra rajnai	HUN	1
kl?ra rajnai, anna pfeffer	HUN	1
knut holmann	NOR	6
knut lindberg, charles luther, ivan m?ller, ture persson	SWE	1
koichi morishita	JPN	1
kokichi tsuburaya	JPN	1
konrad wasielewski, michal jelinski, marek kolbowicz, adam korol	POL	1
konstantinos kenteris	GRE	1
kornelia ender	GDR	4
kosuke hagino	JPN	1
kosuke kitajima	JPN	4
kosuke kitajima, takeshi matsuda, takuro fujii, ryosuke irie	JPN	1
kriss akabusi	GBR	1
kriss akabusi, todd bennett, phil brown, garry cook	GBR	1
kristian hellstr?m	SWE	1
kristina mundt, beate schramm, jana sorgers, kerstin f?rster	GDR	1
kristin otto	GDR	4
kristoffer leps?, thor pedersen, leif n?ss, carl henrik monssen, sigurd monssen, harald kr?kenes, thorstein kr?kenes, hans eigil hansen, halfdan gran olsen	NOR	1
kristy kowal	USA	1
krisztian bartfai, krisztian vereb	HUN	1
krisztina egerszegi	HUN	7
k?roly bartha	HUN	1
k?roly g?ttler	HUN	2
k?roly levitzky	HUN	1
kruska larsen	NOR	1
k?the krau?	GER	1
kurt grote, josh davis, mark henderson, gary hall jr., john hargis, jeremy linn, jeff rouse, tripp schwenk	USA	1
kurt malisch	DEU	1
kurt moeschter, bruno m?ller	GER	1
kusuo kitamura	JPN	1
kyoko iwasaki	JPN	1
lacey hearn	USA	1
laimute baikauskaite	URS	1
lajos kiss	HUN	1
lalka berberova, radka stoyanova	BUL	1
lalonde gordon	TTO	1
lalonde gordon, deon lendore, jarrin solomon, ade alleyne-forte	TTO	1
lance larson	USA	1
larion serghei, policarp malihin	ROM	1
larisa kruglova, irina khabarova, olga fyodorova, yuliya tabakova	RUS	1
larisa merk, oxana dorodnova, irina fedotova, ioulia levina	RUS	1
larry black	USA	1
larry cain	CAN	2
larry james	USA	1
larry young	USA	2
lars bj?nness, rolf thorsen, kjetil undset, per s?tersdal	NOR	1
larsen jensen	USA	2
lars-erik moberg	SWE	1
lars-erik moberg, per-inge bengtsson	SWE	1
lars fr?lander	SWE	1
lars fr?lander, anders holmertz, anders lyrbring, christer wallin	SWE	1
lars kober, stefan utess	GER	1
lars wolfbrandt, kurt lundqvist, rune larsson, folke alnevik	SWE	1
lashawn merritt	USA	1
lashinda demus	USA	1
lasse vir?n	FIN	4
laszlo cseh	HUN	5
laurel korholz, samantha magee, anna mickelson, lianne nelson, mary whipple, megan dirkmaat, kate johnson, caryn davies, alison cox	USA	1
laure manaudou	FRA	3
lauri lehtinen	FIN	2
lauri nevalainen, oiva lommi, veikko lommi, kauko wahlsten	FIN	1
lauri siering, camille wright, shirley babashoff, linda jezek	USA	1
lauri virtanen	FIN	2
lauryn williams	USA	1
lavonna martin	USA	1
lea loveless	USA	1
leamon king, thane baker, bobby morrow, ira murchison	USA	1
ledys frank balceiro	CUB	1
lee calhoun	USA	2
lee evans	USA	1
lee evans, ron freeman, larry james, vincent matthews	USA	1
leendert van dis, henricus droog	NED	1
leisel jones	AUS	5
leisel jones, alicia coutts, melanie schlanger, emily seebohm	AUS	1
leni lohmar, gisela arendt, ruth halbsguth, inge schmitz	GER	1
lennart strand	SWE	1
lennox miller	JAM	2
lenny krayzelburg	USA	2
lenore kight-wingard	USA	2
leobaldo pereira, ibrahim rojas	CUB	1
leonel manzano	USA	1
leonid bartenev, yuri konovalov, gusman kosanov, edvins ozolins	URS	1
leonid geyshtor, sergey makarenko	URS	1
leonid ilyichov, vladimir kosinsky, vladimir nemshilov	URS	1
leonid spirin	URS	1
leon rotman	ROM	2
les carney	USA	1
lesley ashburner	USA	1
leslie cliff	CAN	1
leslie rich, harry hebner, leo goodwin, charles daniels	USA	1
leszek dunecki, zenon licznerski, marian woronin, krzysztof zwoliwski	POL	1
lewis clive, hugh edwards	GBR	1
lewis tewanima	USA	1
liam heath, jon schofield	GBR	1
libby trickett	AUS	2
lida van der anker-doedens	NED	1
lidia simon	ROM	1
liliana gafencu, elena georgescu, vera cochelea, doina ignat, elisabeta lipa, anca tanase, doina spircu, marioara popescu, ioana olteanu	ROM	1
li lin	CHN	4
liliya nurutdinova	URS	1
lillian board	GBR	1
limin liu	CHN	1
lina kaciusyte	URS	1
lina radke	GER	1
linda gustavson	USA	2
linda mackenzie, melanie schlanger, stephanie rice, kylie palmer, lara davenport, angie bainbridge, bronte barratt, felicity galvez	AUS	1
lindsay burns, teresa bell	USA	1
lindsay wilson, ivan sutherland, dave rodger, alex mclean, trevor coker, simon dickie, peter dignan, athol earl, tony hurt	NZL	1
lindy remigino	USA	1
linford christie	GBR	2
linsey macdonald, michelle probert, joslyn hoyte-smith, donna-marie hartley	GBR	1
liping wang	CHN	1
lisa carrington	NZL	1
lisa jacob, trina jackson, sheila taormina, cristina teuscher, annette salmeen, ashley whitney, jenny thompson	USA	1
lisa martin	AUS	1
lisbeth lenton	AUS	1
liuyang jiao	CHN	1
liu zige	CHN	1
livio berruti	ITA	1
llewellyn herbert	RSA	1
lloyd labeach	PAN	2
lord david burghley	GBR	1
lord david burghley, thomas hampson, godfrey rampling, crew stoneley	GBR	1
lorenzo carboncini, riccardo deirossi, valter molea, carlo mornati	ITA	1
lori melien, andrea nugent, jane kerr, allison higson	CAN	1
lorraine crapp	AUS	2
lorraine graham	JAM	1
lorraine moller	NZL	1
lothar kn?rzer, heinz f?tterer, manfred germar, leo pohl	GER	1
lotte friis	DEN	1
lotte m?he	GER	1
louis clarke, frank hussey, alfred leconey, loren murchison	USA	1
louise j?hncke, anna-karin kammerling, josefin lillhage, therese alshammar, malin svahnstrom, johanna sj?berg	SWE	1
louis gantois	FRA	1
l?szl? folt?n, istv?n vaskuti	HUN	1
luca sacchi	ITA	1
lucy morton	GBR	1
lucyna langer	POL	1
ludmila engquist	SWE	1
ludy langer	USA	1
luguelin santos	DOM	1
luigi beccali	KIT	2
luis las?rtegui, fernando climent	ESP	1
lutz altepost, norman brockl, bjorn hogel goldschmidt, torsten eckbrett	GER	1
lutz ulbricht, niko ott, horst meyer, j?rg siebert, g?nther tiersch, dirk schreyer, r?diger henning, egbert hirschfelder, wolfgang hottenrott	FRG	1
lyndon ferns, roland schoeman, ryk neethling, darian townsend	RSA	1
lyndsie fogarty, hannah davis, chantal meek, lisa oldenhof	AUS	1
lynette mcclements	AUS	1
lynn burke	USA	1
lynn colella	USA	1
lynn jennings	USA	1
lynn vidali	USA	2
lyubomir lyubenov	BUL	2
lyubomir petrov, ivo rusev, mincho nikolov, bogdan dobrev	BUL	1
lyubov rusanova	URS	2
lyudmila bragina	URS	1
lyudmila dzhigalova, olga bryzgina, yelena ruzina, olga nazarova	URS	1
lyudmila kondratyeva	URS	1
lyudmila maslakova, natalya bochina, vera anisimova, vera komisova	URS	1
lyudmila pinayeva-khvedosyuk	URS	2
lyudmila pinayeva-khvedosyuk, yekaterina kuryshko	URS	1
lyudmila rogachova	URS	1
lyudmila shevtsova	URS	1
mable fergerson, kathy hammond, cheryl toussaint, madeline manning-jackson	USA	1
maciej freimut, wojciech krupiewski	POL	1
mack robinson	USA	1
madeline manning-jackson	USA	1
mads kruse andersen, morten j?rgensen, eskild ebbesen, thomas ebert	DEN	1
mads rasumussen, rasmus hansen	DEN	1
magdalena stoyanova georgieva	BUL	1
mahe drysdale	NZL	2
mahiedine mekhissibenabbad	FRA	1
mahiedine mekhissi-benabbad	FRA	1
maike nollen, carolin leonhardt, birgit fischer, katrin wagner	GER	1
mai nakamura	JPN	1
maiola kalili, manuella kalili, george fissler, frank booth	USA	1
makoto fukui, kunihiro iwasaki, toshio shoji, yukiaki okabe	JPN	1
malcolm carmichael, charles wiggin	GBR	1
malcolm spence	SAF	1
malia metella	FRA	1
mal whitfield	USA	3
mal whitfield, arthur harnden, roy cochran, clifford bourland	USA	1
mamo wolde	ETH	3
manfred kinder, martin jellinghaus, gerhard hennige, helmar m?ller	FRG	1
manfred klein, armin eichholz, thomas domian, ansgar wessling, eckhardt schultz, bahne rabe, wolfgang maennig, matthias mellinghaus, thomas m?llenkamp	FRG	1
manuela lutze, manja kowalski, kerstin el qalqili-kowalski, meike evers	GER	1
manuela lutze, meike evers, kerstin el qalqili-kowalski, kathrin boron	GER	1
manuela stellmach	GDR	1
manuel dos santos	BRA	1
manuel plaza reyes	CHI	1
marc bouissou, roger gautier, jacques guissart, pierre blondiaux	FRA	1
marc burns, keston bledman, emmanuel callender, richard thompson	TTO	1
marc detton, jean-pierre stock	FRA	1
marcel hacker	GER	1
marcel hansenne	FRA	1
marcia jones	USA	1
marc weber, roland baar, detlef kirchhoff, mark kleinschmidt, wolfram huhn, frank richter, ulrich viefers, thorsten streppelhoff, peter thiede	GER	1
marek dopierala, marek lbik	POL	1
marek lbik, marek dopierala	POL	1
marek witkowski, adam seroczynski, grzegorz kotowicz, dariusz bialkowski	POL	1
margaret bailes, barbara ferrell, wyomia tyus, mildrette netter	USA	1
margarete adler, klara milch, josephine sticker, berta zahourek	AUT	1
margaret edwards	GBR	1
margaret hoelzer	USA	2
margot marsman, marie-louise linssen-vaessen, irma heijting-schuhmacher, hanny termeulen	NED	1
maria braun	NED	2
maria cioncan	ROM	1
maria gommers	NED	1
maria mutola	MOZ	2
mariana limbau, elena radu, raluca andreea ionita, sanda toma	ROM	1
marianne heemskerk	NED	1
marianne kriel	RSA	1
marianne limpert	CAN	1
maria teresa ramirez	MEX	1
maria vasco	ESP	1
maricica puica	ROM	1
marie baron	NED	1
mariechen wehselau	USA	1
marie delattre, anne-laure viard	FRA	1
marie-jos? p?rec	FRA	3
marie-louise linssen-vaessen	NED	1
marilyn black	AUS	1
marilyn ramenofsky	USA	1
marina koshevaya	URS	2
marina yurchenya	URS	1
marinus van den berge, jacob boot, jan de vries, henricus broos	NED	1
mario lanzi	KIT	1
marion shields	USA	1
marise chamberlain	NZL	1
marita koch	GDR	1
mariya pinigina, olga nazarova, tatyana ledovskaya, olga bryzgina	URS	1
mariya savinova	RUS	1
marjorie jackson	AUS	2
mark crear	USA	2
mark de jonge	CAN	1
mark hunter, zac purchase	GBR	1
mark kerry	AUS	1
mark kerry, neil brooks, peter evans, mark tonelli	AUS	1
mark lewis-francis, jason gardener, marlon devonish, darren campbell	GBR	1
mark mccoy	CAN	1
mark oldershaw	CAN	1
mark richardson, roger black, jamie baulch, iwan thomas	GBR	1
mark rowland	GBR	1
mark spitz	USA	6
mark spitz, don schollander, john nelson, stephen rerych	USA	1
mark stockwell	AUS	1
mark tewksbury	CAN	1
mark tewksbury, thomas ponting, victor davis, sandy goss	CAN	1
markus gier, michael gier	SUI	1
markus rogan	AUT	2
markus ryffel	SUI	1
mark warnecke	GER	1
mark zabel, andreas ihle, bjorn bach, stefan ulm	GER	1
marleen veldhuis	NED	1
marleen veldhuis, inge de bruijn, inge dekker, chantal groot, annabel kosten	NED	1
marlene mathews	AUS	2
marlies g?hr-oelsner	GDR	1
marnie mcbean, diane o?grady, laryssa biesenthal, kathleen heddle	CAN	1
marnie mcbean, kathleen heddle	CAN	1
martha genenger	GER	1
martha langbein, annie biechl, jutta heine, brunhilde hendrix	GER	1
martha norelius	USA	2
martha norelius, adelaide lambert, albina osipowich, eleanor garatti-saville	USA	1
martha randall	USA	1
martina grimaldi	ITA	1
martina grunert, roswitha krause, uta schmuck, gabriele wetzko	GDR	1
martina moravkova	SVK	2
martin doktor	CZR	2
martin fromanack, charles aman, michael begley, frederick suerig, gustav voerg, frank dummerth, john freitag, louis helm	USA	1
martin georgiev marinov	BUL	1
martin georgiev marinov, blagovest stoyanov	BUL	1
martin hawkins	USA	1
martin hollstein, andreas ihle	GER	1
martin karl, rudolf eckstein, toni rom, willi menne	GER	1
martin l?pez-zubero	ESP	1
martin sinkovic, valent sinkovic, damir martin, david sain	CRO	1
martin winter, frank dundr, karsten bunk, uwe heppner	GDR	1
martti marttelin	FIN	1
martyn woodroffe	GBR	1
maryam yusuf jamal	BRN	1
mary carew, evelyn furtsch, wilhelmina von bremen, annette rogers	USA	1
maryna pautaran, volha khudzenka, nadzeya papok, iryna pamialova	BLR	1
mary onyali	NGR	1
mary rand, janet simpson, daphne arden, dorothy hyman	GBR	1
mary sears	USA	1
mary t meagher	USA	3
mary t meagher, nancy hogshead, tracey caulkins, theresa andrews	USA	1
maryvonne dupureur	FRA	1
mary washburn, elizabeth robinson, jessie cross, loretta mcneil	USA	1
mary wayte	USA	1
masahiro yoshimura	JPN	1
masaji kiyokawa	JPN	2
masami tanaka, mai nakamura, sumika minamoto, junko onishi	JPN	1
masaru furukawa	JPN	1
masonori yusa	JPN	1
massimiliano rosolino	ITA	3
massimiliano rosolino, matteo pelliciari, filippo magnini, emiliano brembilla, federico cappellazzo, simone cercato	ITA	1
mate trojanovic, petar segvic, duje bonacic, velimir valenta	YUG	1
matija ljubek	YUG	2
matija ljubek, mirko nisovic	YUG	1
matt biondi	USA	5
matt biondi, chris cavanaugh, mike heath, ambrose gaines	USA	1
matt biondi, troy dalbey, chris jacobs, thomas jager	USA	1
matt grevers	USA	1
matthew birir	KEN	1
matthew grevers	USA	1
matthew long, james tomkins	AUS	1
matthew pinsent, steven redgrave	GBR	1
matthew wells, stephen rowbotham	GBR	1
matthew welsh	AUS	2
matt targett, christian sprenger, hayden stoeckel, eamon sullivan, ashley delaney, andrew lauterstein, adam pine, brenton rickard	AUS	1
matt vogel	USA	1
maurice delvart, andr? devaux, gaston f?ry, g?o andr?	FRA	1
maurice greene	USA	2
maurice herriott	GBR	1
maurizio damilano	ITA	3
mavis freeman, bernice lapp, olive mckean, katherine rawls	USA	1
maxey long	USA	1
max hoff	GER	1
maxim opalev	RUS	3
max metzker	AUS	1
max raub, herbert wiedermann	AUT	2
maxwell eley, robert morrison, terence sanders, james macnabb	GBR	1
mayumi aoki	JPN	1
mbulaeni mulaudzi	RSA	1
mebrahtom keflezighi	USA	1
megan jendrick, margaret hoelzer, elaine breeden, natalie coughlin, kara lynn joyce, christine magnuson, dara torres, rebecca soni	USA	1
megan kalmoe, kara kohler, adrienne martelli, natalie dell	USA	1
megan quann	USA	1
megan still, kate slatter	AUS	1
meinrad miltenberger, michael scheuer	GER	1
melaine walker	JAM	1
melissa belote	USA	2
melissa morrison	USA	2
melvin patton	USA	1
melvin sheppard	USA	3
melvin sheppard, ted meredith, charles reidpath, edward lindberg	USA	1
melvin stewart	USA	1
meng guanliang, yang wenjun	CHN	1
merlene ottey-page	JAM	7
merlene ottey-page, beverly mcdonald, tanya lawrence, veronica campbell	JAM	1
merv wood	AUS	2
meseret defar	ETH	3
micah kogo	KEN	1
michael bates	USA	1
michael d?rsch, albert hedderich, raimund h?rmann, dieter wiedenmann	FRG	1
michael gro?	FRG	4
michael hart, chris baillieu	GBR	1
michael holthaus	FRG	1
michael jamieson	GBR	1
michael johnson	USA	3
michael johnson, steve lewis, quincy watts, andrew valmon	USA	1
michael klim	AUS	1
michael klim, toby haenen, steven dewick, scott miller, philip rogers	AUS	1
michael kolganov	ISR	1
michael larrabee	USA	1
michael larrabee, ulis williams, henry carr, ollan cassell	USA	1
michael mathieu, ramon miller, avard moncur, christopher brown, andretti bain, andrae williams	BAH	1
michael phelps	USA	13
michael ryan	NZL	1
michael shine	USA	1
michael staines, calvin coffey	USA	1
michael stamm	USA	2
michael steinbach, stephan volkert, andr? willms, andreas hajek	GER	1
michael tinsley	USA	1
michael troy	USA	1
michael wenden	AUS	2
michael west	CAN	1
michael west, thomas ponting, sandy goss, victor davis	CAN	1
michal riszdorfer, richard riszdorfer, juraj baca, erik vlcek	SVK	1
michel andrieux, jean-christophe rolland	FRA	1
michel chapuis, jean boudehen	FRA	1
michele pearson	AUS	1
michel jazy	FRA	1
michelle ford	AUS	2
michelle guerette	USA	1
michelle richardson	USA	1
michelle smith	IRL	4
michel th?ato	FRA	1
mich?le chardonnet	FRA	1
mieke jaapies	NED	1
miguel seijas, juan rodriguez	URU	1
miguel white	PHI	1
mihai zafiu, nicusor esanu, vasile diba, lon geanta	ROM	1
mihai zafiu, roman vartolomeu, aurel vernescu, atanase sciotnic	ROM	1
mih?ly hesz	HUN	2
mikael ?rn, bengt baron, per johansson, thomas lejdstr?m	SWE	1
mike barrowman	USA	1
mike boit	KEN	1
mike bruner	USA	1
mike burton	USA	3
mike heath	USA	1
mike lewis, liam parsons, jon beare, iain brambell	CAN	1
mike marsh	USA	1
mike mckay, james tomkins, andrew cooper, nicholas green	AUS	1
mike mckay, stuart reside, stuart welch, geoff stewart, james stewart, steve stewart, michael toon, stefan szczurowski, bo hanson	AUS	1
mike mcleod	GBR	1
mike musyoki	KEN	1
mike o'brien	USA	1
mikhail kaaleste, anatoly demitkov	URS	1
mikhail shchennikov	RUS	1
mikhail slivinsky	URS	2
mikhail zamotin, naum prokupets	URS	1
miki nakao	JPN	1
milan janic	YUG	1
millard hampton	USA	1
millon wolde	ETH	1
milorad cavic	SRB	1
milosz bernatajtys, bartlomiej pawelczak, lukasz pawlowski, pawel randa	POL	1
mina wylie	ANZ	1
mireia belmonte garcia	ESP	2
mirka knapkova	CZE	1
mirko nisovic, matija ljubek	YUG	1
mirna jukic	AUT	1
miroslav kon?cek, bohumil janousek, jan jindra, jir? lund?k, stanislav lusk, v?clav pavkovic, ludek pojezny, josef ventus, jan sv?da	CZE	1
miruts yifter	ETH	3
missy franklin	USA	2
missy schwen, karen kraft	USA	2
misty hyman	USA	1
mitchell ivey	USA	2
mitica pricop, florin popescu	ROM	1
mitzi kremer, dara torres, laura walker, mary wayte	USA	1
mizuki noguchi	JPN	1
mo farah	GBR	2
mohamed gammoudi	TUN	4
mohamed sulaiman	QAT	1
mohammed kedir	ETH	1
moira abernethy, jeanette myburgh, nathalie myburgh, susan roberts	SAF	1
monika zehrt	GDR	1
morgan taylor	USA	3
morris kirksey	USA	1
morris kirksey, loren murchison, charles paddock, jackson scholz	USA	1
moses kiptanui	KEN	1
murray halberg	NZL	1
murray riley, merv wood	AUS	1
murray rose	AUS	4
murray rose, kevin o'halloran, jon henricks, john devitt	AUS	1
myrtle cook, florence bell, fanny rosenfeld, ethel smith	CAN	1
nadezhda ilyina, inta klimovica, lyudmila aksenova, natalya sokolova	URS	1
nadezhda khnykina	URS	1
nadezhda olizarenko	URS	2
naftali temu	KEN	2
naman keita	FRA	1
nancy garapick	CAN	2
nancy hogshead	USA	2
nancy lagat	KEN	1
nancy ramey	USA	1
naoko takahashi	JPN	1
narcisco su?rez, enrique miguez	ESP	1
natalia antyukh	RUS	1
natalie coughlin	USA	5
natalie steward	GBR	2
nataliya tobias	UKR	1
natallia helakh, yuliya bichyk	BLR	1
natalya antyukh	RUS	1
natalya antyukh, tatiana firova, yulia gushchina, antonina krivoshapka	RUS	1
natalya bochina	URS	1
natalya lavrinenko, tamara davydenko, marina znak, natalya volchek, natalya stasyuk, valentina skrabatun, yelena mikulich, aleksandra pankina, yaroslava pavlovich	BLR	1
natalya lebedeva	URS	1
natalya pechenkina	URS	1
natalya ustinova, tatyana savelyeva, svetlana babalina, tatyana devyatova	URS	1
natasa janic	HUN	1
natasa janics	HUN	1
natasa janics, katalin kovacs	HUN	2
nate cartmell	USA	3
nathan adrian	USA	1
nathan baggaley	AUS	1
nathan cohen, joseph sullivan	NZL	1
nathan deakes	AUS	1
natsumi hoshi	JPN	1
nawal el moutawakel	MAR	1
neil cochran	GBR	1
neil walker, gary hall jr., tommy hannan, jason lezak, lenny krayzelburg, ian crocker, ed moses	USA	1
neisser bent	CUB	1
nelly van vliet	NED	1
nelson diebel	USA	1
neville hayes	AUS	1
neville hayes, terry gathercole, geoffrey shipton, david theile	AUS	1
nicholas willis	NZL	1
nick gillingham	GBR	2
nick thoman	USA	1
nicole haislett	USA	1
nicole stevenson	AUS	1
nico rienks, ronald florijn	NED	1
nida senff	NED	1
niels henriksen, victor feddersen, eskild ebbesen, thomas poulsen	DEN	1
nigel barker	AUS	2
nijel amos	BOT	1
nijole sabaite	URS	1
nikki payne, lynley hannen	NZL	1
nikolaos skiathitis, vasileios polymeros	GRE	1
nikolay bukhalov	BUL	3
nikolay chernetsky, mikhail linge, viktor markin, remigijus valiulis	URS	1
nikolay dovgan, valery kleshnyov, yevgeny barbakov, yury shapochka	URS	1
nikolay gorbachov, viktor kratasyuk	URS	1
nikolay kirov	URS	1
nikolay kolesnikov, valery borzov, aleksandr aksinin, juris silovs	URS	1
nikolay kuznetsov, raul arnemann, valery dolinin, anushavan gassan-dzhalilov	URS	1
nikolay pankin	URS	1
nikolay pimenov, yury pimenov	URS	1
nikolay sidorov, vladimir muravyov, andrey prokofyev, aleksandr aksinin	URS	1
nikolay smaga	URS	1
nikolay sokolov	URS	1
nikolina shtereva	BUL	1
niksa skelin, sinisa skelin	CRO	1
nils bj?rkl?f, ture axelsson	FIN	1
nils engdahl	SWE	1
nils fjeldheim, eirik larsen	NOR	1
nils schumann	GER	1
nimrod greenwood, david anderson, mervyn finlay, philip cayzer, ernest chapman, thomas chessel, edward pain, robert tinning, geoffrey willamson	AUS	1
nina savina	URS	1
nina trofimova-gopova, galina alekseyeva-kreft	URS	1
nina zhivanevskaya	ESP	1
nina zhivanevskaya, olga kirichenko, elena choubina, yelena rudkovskaya, natalya meshcheryakova	URS	1
nixon kiprotich	KEN	1
n?ndor d?ni	HUN	1
noah ngeny	KEN	1
noboru terada	JPN	1
nobuharu asahara, shingo suetsugu, shinji takahira, naoki tsukahara	JAP	1
nobuo arai, tokuhei sada, hiroshi yoneyama, katsuo takaishi	JPN	1
nobutaka taguchi	JPN	2
noe hernandez	MEX	1
noel freeman	AUS	1
noemi ildik? lung	ROM	2
no?l de mille, ned pratt	CAN	1
norbert ke?lau, guido grabow, volker grabow, j?rg puttlitz	FRG	1
norberto t?llez, l?zaro mart?nez, roberto hern?ndez, h?ctor herrera	CUB	1
norbert r?zsa	HUN	3
norman hallows	GBR	1
norman pritchard	BIN	1
norman ross	USA	2
norman taber	USA	1
norm read	NZL	1
noureddine morceli	ALG	1
nouria merah-benida	ALG	1
nouzha bidouane	MAR	1
novella calligaris	ITA	3
obadele thompson	BAR	1
olaf heukrodt	GDR	2
olaf heukrodt	GER	1
olaf heukrodt, uwe madeja	GDR	1
olaf tufte	NOR	2
olaf tufte, fredrik raaen bekken	NOR	1
olapade adeniken, davidson ezinwa, chidi imoh, oluyemi kayode	NGR	1
oleg gorobiy, anatoliy tishchenko, sergey verlin, georgy tsybulnikov	RUS	1
oleg tyurin, boris dubrovsky	URS	1
olena krasovska	UKR	1
olesya zykina, natalia antyukh, natalya nazarova, olesya krasnomovets	RUS	1
olga bogoslovskaya, galina malchugina, irina privalova, marina trandenkova	URS	1
olga bondarenko	URS	1
olga bryzgina	URS	2
olga homeghi, herta anitas, rodica arba, mihaela armasescu, adriana bazon-chelariu, ekaterina oancia, veronica necula	ROM	1
olga kaniskina	RUS	2
olga nazarova	URS	1
olga shishigina	KAZ	1
olimpiada ivanova	RUS	1
oliver kegel, thomas reineck, mario von appen, andr? wohllebe	GER	1
ollie matson	USA	1
ollie matson, gene cole, mal whitfield, charles moore	USA	1
ondrej synek	CZE	1
ondrej synek	CZR	1
ophelie-cyrielle etienne, camille muffat, coralie balmy, charlotte bonnet	FRA	1
oscar taelman, r?my orban, rodolphe poma, georges mijs, marcel morimont, alfred vanlandeghem, polydore veirman, fran?ois vergucht, oscar charles de somville, john burn, oswald carver, gordon balfour, richard boyle, douglas kertland, harold kitching, walter lewis, henry goldsmith, frank jerwood, becher robert gale, julius thomson, edward williams, george wright, charles riddy, irvine robertson, eric powell, geoffrey taylor, douglas stuart	GBR	1
oszk?r frey, tam?s buday	HUN	1
otis davis	USA	1
otis harris jr	USA	1
otto fahr	DEU	1
otto herschmann	AUT	1
ottorino quaglierini, cesare milani, dante secchi, enrico garzelli, oreste grossi, mario checcacci, guglielmo del bimbo, dino barsotti, enzo bartolini	KIT	1
otto scheff	AUT	3
otylia jedrzejczak	POL	3
oussama mellouli	TUN	3
ove andersen	FIN	1
paavo nurmi	FIN	7
pablo morales	USA	3
pamela jelimo	KEN	1
pamela kruse	USA	1
pamela rai, michelle macpherson, anne ottenbrite, reema abdo	CAN	1
pang jiaying	CHN	1
pang jiaying, zhu qianwei, tan miao, tang jingzhi, yang yu	CHN	1
paola cacchi-pigni	ITA	1
park taehwan	KOR	2
partridge, foad, ransley, egington, sbihi, searle, langridge, louloudis, hill	GBR	1
pascal touron, frederic dufour	FRA	1
pascal touron, thibaud chapelle	FRA	1
pat costello, jim gardiner	USA	1
patricia girard-l?no	FRA	1
patricia jones, viola myers, nancy mackay, diane foster	CAN	1
patrick flynn	USA	1
patrick k?hl	GDR	1
patrick lefoulon, bernard bregeon	FRA	1
patrick sang	KEN	1
paula ivan	ROM	1
paul bitok	KEN	2
paul bontemps	FRA	1
paul costello, charles mcilvane	USA	1
paul drayton	USA	1
paul ereng	KEN	1
paul-heinz wellmann	FRG	1
paul hoekstra, anton geurts	NED	1
paul howe, neil cochran, paul easter, andrew astbury	GBR	1
pauline davis-thompson	BAH	1
pauline konga	KEN	1
paul kellner	DEU	1
paul kingsman	NZL	1
paul kipsiele koech	KEN	1
paul macdonald	NZL	1
paul macdonald, ian ferguson	NZL	1
paul martin	SUI	1
paul nihill	GBR	1
paul palmer	GBR	1
paul pilgrim	USA	2
paul radmilovic, rob derbyshire, william foster, henry taylor	GBR	1
paul tergat	KEN	2
paul wolf, ralph flanagan, john macionis, jack medica	USA	1
paul wyatt	USA	2
pavel khnykin, vladislav kulikov, vasily ivanov, vladimir selkov, vladimir pyshnenko, aleksandr popov, dmitry volkov	URS	1
pavel khnykin, yury bashkatov, gennady prigoda, vladimir pyshnenko, aleksandr popov, veniamin tayanovich	URS	1
pekka vasala	FIN	1
penny heyns	RSA	3
pepijn aardewijn, maarten van der linden	NED	1
percy beard	USA	1
percy hodge	GBR	1
percy williams	CAN	2
per holmertz	SWE	1
per johansson	SWE	2
per olof ?strand	SWE	1
perry mcgillivray, norman ross, pua kealoha, duke kahanamoku	USA	1
pertti karppinen	FIN	3
petar merkov	BUL	2
petar petrov	BUL	1
peter antonie, stephen hawkins	AUS	1
peter elliott	GBR	1
peter evans	AUS	2
peter evans, glenn buchanan, mark kerry, mark stockwell	AUS	1
peter frenkel	GDR	2
peter higgins, derek johnson, john salisbury, michael wheeler	GBR	1
peter jackson, john sturrock, thomas bristow, alan barrett	GBR	1
peter kersten	GDR	1
peter koech	KEN	1
peter kretschmer, kurt kuschela	GER	1
peter michael kolbe	FRG	3
peter nocke	FRG	1
peter nocke, walter kusch, michael kraus, klaus steinbach	FRG	1
peter norman	AUS	1
peter olsen, harry larsen	DEN	1
peter radford	GBR	1
peter raymond, lawrence terry, timothy mickelson, john livingston, michael livingston, eugene clapp, fritz hobbs, william hobbs, paul hoffman	USA	1
peter rocca	USA	2
peter rono	KEN	1
peter snell	NZL	3
peter taylor, storm uru	NZL	1
peter vanderkaay	USA	2
peter vanderkaay, erik vendt, david walters, ricky berens, michael phelps, ryan lochte, klete keller	USA	1
peter vanderkaay, michael phelps, ryan lochte, scott goldblatt, dan ketchum, klete keller	USA	1
petra m?ller	GDR	1
petra priemer	GDR	1
petra riedel	GDR	1
petra schneider	GDR	2
petra th?mer	GDR	2
petra van staveren	NED	1
petra zindler	FRG	1
petria thomas	AUS	4
petru iosub, valer toma	ROM	1
philip edwards	CAN	3
philip johnson, laurence hough	USA	1
philip noel-baker	GBR	1
philippe boccara, pascal boucherit, fran?ois barouh, didier vavasseur	FRA	1
philip rogers	AUS	1
philip verdon, george fairbairn, willy d?skow, norwey jackes, f b toms, martin stahnke	DEU	1
phillip hubble	GBR	1
phyllis harding	GBR	1
pier angelo conti manzini, abramo albini, tullio baraglia, renato bosatta	ITA	1
piero poli, davide tizzano, agostino abbagnale, gianluca farina	ITA	1
pierre-jean peltier, julien bahain, c?dric berrest, jonathan coeffic	FRA	1
pieter van den hoogenband	NED	5
pieter van den hoogenband, mark veens, mitja zastrow, klaas-erik zwering, johan kenkhuis	NED	1
pietro ivanov, latino galasso, giuseppe grivelli, vittorio gliubich, antonio cattalinich, francesco cattalinich, simeone cattalinich, carlo toniatti, bruno sorich	KIT	1
pietro mennea	ITA	2
pino dordoni	ITA	1
piotr markiewicz	POL	1
pokey watson	USA	1
polydore veirman	BEL	1
pontus hanson	SWE	1
p?r arvidsson	SWE	1
priscah jeptoo	KEN	1
priscilla lopesschliep	CAN	1
pua kealoha	USA	1
puck oversloot, corrie ladd?, willie den ouden, marie vierdag	NED	1
pyotr bolotnikov	URS	1
pyotr pochenchuk	URS	1
quincy watts	USA	1
rachael taylor, kate slatter	AUS	1
rachid el basir	MAR	1
raelene boyle	AUS	3
rafael vidal	VEN	1
rafal piszcz, wladyslaw szuszkiewicz	POL	1
rafal szukala	POL	1
ragnhild hveger	DEN	1
ralf l?bke, norbert dobeleit, edgar itt, j?rg vaihinger	FRG	1
ra?l gonz?lez	MEX	2
ralph craig	USA	2
ralph doubell	AUS	1
ralph hill	USA	1
ralph hutton	CAN	1
ralph mann	USA	1
ralph metcalfe	USA	3
raman piatrushenka, vadzim makhneu	BLR	2
ramona portwich, anke nothnagel-von seck	GER	1
ramon de clemente, donovan cech	RSA	1
ramon miller, chris brown, michael mathieu, demetrius pinder	BAH	1
ran laurie, jack wilson	GBR	1
ranomi kromowidjojo	NED	2
raoul rodriguez, thomas bohrer, richard kennelly, david krmpotich	USA	1
rashid ramzi	BRN	1
rasmus quist, mads reinholdt rasmussen	DEN	1
ray armstead, alonzo babers, antonio mckay, sunder nix	USA	1
ray kegeris	USA	1
raymond barbuti	USA	1
ray stewart, don quarrie, al lawrence, greg meghoo	JAM	1
razvan florea	ROM	1
r?diger helm	GDR	3
r?diger helm, bernd duvigneau, bernd olbricht, harald marg	GDR	1
r?diger helm, bernd olbricht	GDR	1
r?diger reiche, karl-heinz bu?ert, wolfgang g?ldenpfennig, michael wolfgramm	GDR	1
rebecca adlington	GBR	4
rebecca sattin, kerry hore, dana faletic, amber bradley	AUS	1
rebecca soni	USA	4
reggie walker	SAF	1
reiko nakamura	JPN	2
reinaldo gorno	ARG	1
reizo koike	JPN	2
renate breuer	FRG	1
renate stecher	GDR	4
renate stecher, b?rbel struppert, christina heinich, evelyn kaufer	GDR	1
ren? tirard, ren? lorain, ren? mourlon, emile ali-khan	FRA	1
reuben kosgei	KEN	1
rex cawley	USA	1
rhadi ben abdesselam	MAR	1
ricardo prado	BRA	1
rica reinisch	GDR	2
richard beesly, edward bevan, john lander, michael warriner	GBR	1
richard burnell, bert bushnell	GBR	1
richard chambers, robert williams, chris bartley, peter chambers	GBR	1
richard chelimo	KEN	1
richard colella	USA	1
richard corts, georg lammers, helmuth k?rnig, hubert houben	GER	1
richard howard	USA	1
richard kipkemboi	KEN	1
richard novy, jan mrv?k, miroslav kon?cek, jir? lund?k, bohumil janousek, ludek pojezny, julius tocek, petr cerm?k, josef ventus	CZE	1
richard roth	USA	1
richard thompson	TRI	1
richard thompson, aaron armstrong, marc burns, emmanuel callender, keston bledman	TRI	1
richard weinberger	CAN	1
richard wohlhuter	USA	1
rick carey	USA	2
rick carey, ambrose gaines, steve lundquist, pablo morales	USA	1
rick mitchell	AUS	1
rie mastenbroek	NED	3
rita k?b?n	HUN	2
rita k?b?n, erika m?sz?ros, ?va d?nusz, kinga czig?ny	HUN	1
rita k?b?n, erika m?sz?ros, ?va rakusz, erika g?czi	HUN	1
rita k?hne, helga seidler, dagmar k?sling, monika zehrt	GDR	1
rita wilden	FRG	1
roberta brunet	ITA	1
robertas zulpa	URS	1
robert baetens, michel knuysen	BEL	1
robert bennett	USA	2
robert boutigny	FRA	1
robert chef d'h?tel, jean kerebel, jacques lunis, fran?ois schewetta	FRA	1
robert cloughen	USA	1
robert cowell	USA	1
robert cusack, yury gromak, gregory rogers, michael wenden, robert windle	AUS	1
robert hackett	USA	1
robert kerr	CAN	2
robert kiesel, hector dyer, emmett toppino, frank wykoff	USA	1
robert korzeniowski	POL	4
robert mcgregor	GBR	1
robert mcmillen	USA	1
robert mills	CAN	1
robert nisbet, terence o'brien	GBR	1
roberto tozzi, pietro mennea, stefano malinverni, mauro zuliani	ITA	1
robert perew, stuart griffing, frederick kingsbury, gregory gates	USA	1
robert richards, anthony edwards, simon burgess, darren balmforth	AUS	1
robert scott, david weightman	AUS	1
robert skelton	USA	1
robert sycz, tomasz kucharski	POL	2
robert taylor	USA	1
robert wilson, philip kueber, david helliwell, william mckerlich, richard mcclure, douglas mcdonald, lawrence west, carlton ogawa, donald pretty	CAN	1
robert windle	AUS	1
robert windle, john ryan, peter doak, david dickson	AUS	1
robert woodhouse	AUS	1
robert young, harold cagle, al fitch, edward o'brien	USA	1
robin backhouse	USA	1
robson da silva	BRA	1
rob waddell	NZL	1
robyn thorn, dawn fraser, lynette bell, janice murphy	AUS	1
rochelle stevens, jearl miles, maicel malone, kim graham	USA	1
rodica arba, olga homeghi	ROM	1
rodney dixon	NZL	1
rodney milburn	USA	1
rodolfo falcon	CUB	1
rod strachan	USA	1
roelof luynenburg, ruud stokvis	NED	1
roger black	GBR	1
roger kingdom	USA	2
roger moens	BEL	1
roger pyttel	GDR	2
roland kokeny, rudolf dombi	HUN	1
roland matthes	GDR	5
roland matthes, lutz unger, klaus katzur, hartmut fl?ckner	GDR	1
roland schoeman	RSA	2
roland wieser	GDR	1
rolf larcher, ernst h?rlimann	SUI	1
rolf peterson	SWE	2
roline repelaer van driel, sarah siegelaar, marlies smulders, helen tanger, annemarieke van rumpt, annemiek de haan, femke dekker, nienke kingma	NED	1
roman sloudnov	RUS	1
romeo bertini	KIT	1
romolo catasta	ITA	1
ronald mills	USA	1
ronald rauhe, tim wiesk?tter	GER	2
ronald weigel	GDR	2
ronald weigel	GER	1
ron clarke	AUS	1
ron delany	IRL	1
ron freeman	USA	1
ronnie-ray smith, melvin pender, jim hines, charlie greene	USA	1
rosa mota	POR	2
roscoe lockwood, edward marsh, john geiger, john exley, james juvenal, edward hedley, louis abell, william carr, harry debaecke	USA	1
rosemarie gabriel	GDR	1
rosemarie whyte, shericka williams, novlene williams-mills, christine day	JAM	1
rossano galtarossa, luca agamennoni, simone venier, simone raineri	ITA	1
ross wales	USA	1
roswitha beier	GDR	1
roswitha beier, kornelia ender, christine herbst, renate vogel	GDR	1
roswitha esser, annemarie zimmermann	FRG	1
roswitha esser, annemarie zimmermann	GER	1
roxana maracineanu	FRA	1
roy cochran	USA	1
roy saari	USA	1
?rp?d lengyel, ?d?n gr?f, ferenc csik, oszk?r abay nemes	HUN	1
rudi harbig, helmut hamann, harry voigt, friedrich von st?lpnagel	GER	1
rudolf reichelt, kurt runge, hans matthiae, max vetter, otto liebing, max br?ske, fritz bartholom?, willi bartholom?, werner dehn	DEU	1
ruggero maregatti, giuseppe castelli, edgardo toetti, gabriele salviati	KIT	1
rui silva	POR	1
rumyana neykova	BUL	3
rune larsson	SWE	1
rupert weinstabl, karl proisl	AUT	1
rusty wailes, robert morey, charles grimes, william becklean, donald beer, caldwell esselstyn, thomas charlton, john cooke, david wight	USA	1
ruta meilutyte	LTU	1
ryan cochrane	CAN	2
ryan lochte	USA	7
ryan lochte, michael phelps, nathan adrian, cullen jones	USA	1
ryan lochte, michael phelps, ricky berens, conor dwyer	USA	1
ryan mitchell, adam pine, ian thorpe, michael klim, regan harrison, geoff huegill, josh watson, matthew welsh	AUS	1
ryosuke irie	JPN	2
ryo tateishi	JPN	1
sabine steinbach	GDR	1
sa?d aouita	MAR	2
sadik mujkic, bojan preseren	YUG	1
salah hissou	MAR	1
sally gunnell	GBR	1
sally jepkosgei kipyego	KEN	1
sally mclellan	AUS	1
sally pearson	AUS	1
salvatore antibo	ITA	1
salvatore morale	ITA	1
samantha riley	AUS	2
sam graddy	USA	1
sam graddy, ron brown, carl lewis, calvin smith	USA	1
samson kitur	KEN	1
samuel barathay, frederic kowal	FRA	1
samuel ferris	GBR	1
samuel kahanamoku	USA	1
samuel matete	ZAM	1
samuel wansiru	KEN	1
sandie richards, michelle burgher, nadia davy, novlene williams	JAM	1
sandra farmer-patrick	USA	1
sandra morgan, faith leech, dawn fraser, lorraine crapp	AUS	1
sandra neilson	USA	1
sandra neilson, melissa belote, deena deardurff, catherine carr	USA	1
sandra v?lker	GER	2
sandro bellucci	ITA	1
sanna sten, minna nieminen	FIN	1
sanya richards	USA	1
sanya richards, monique henderson, monique hennagan, deedee trotter	USA	1
sanya richards, monique henderson, natasha hastings, allyson felix, mary wineberg	USA	1
sanya richards-ross	USA	1
sarah hardcastle	GBR	2
sarah outhwaite, kate hornsey	AUS	1
sarah p?we, antje buschschulte, franziska van almsick	GER	1
sarah winckless, elise laverick	GBR	1
sara isakovic	SLO	1
sara nordenstam	NOR	1
saso mirjanic, sadik mujkic, milan jansa, janez klemencic	SLO	1
satoko tanaka	JPN	1
satomi suzuki	JPN	2
satymkul dzhumanazarov	URS	1
saul craviotto rivero	ESP	1
schuyler enck	USA	1
scott frandsen, david calder	CAN	1
scott gault, charles cole, glenn ochal, henrik rummel	USA	1
scott goldblatt, nate dusing, chad carvin, josh davis, klete keller, jamie rauch	USA	1
scott goodman	AUS	1
scott miller	AUS	1
sebastian brendel	GER	1
sebastian coe	GBR	4
sebastien vieilledent, adrien hardy	FRA	1
seleshi sehen	ETH	1
semyon belitz-geyman, vladimir bure, georgi kulikov, leonid ilyichov	URS	1
semyon rzhishchin	URS	1
sergeij fedorovtsev, igor kravtsov, nikolai spinev, alexeij svirin	RUS	1
sergey chukhray, aleksandr degtyarev, yury filatov, vladimir morozov	URS	1
sergey chukhray, vladimir parfenovich	URS	1
sergey fesenko	URS	2
sergey kirdyapkin	RUS	1
sergey koplyakov	URS	1
sergey nagorny, vladimir romanovsky	URS	2
sergey petrenko, aleksandr vinogradov	URS	1
sergey postrekhin	URS	2
sergey ulegin, alexander kostoglod	RUS	1
serghei covaliov, ivan patzaichin	ROM	1
sergij grin, sergij bilushchenko, oleg lykov, leonid shaposhnikov	UKR	1
sergio l?pez	ESP	1
sevatheda fynes, debbie ferguson, pauline davis-thompson, chandra sturrup	BAH	1
seymour cromwell, james storm	USA	1
shalane flanagan	USA	1
shane gould	AUS	5
shannon smith	CAN	1
sharon finneran	USA	1
sharon stouder	USA	2
sharon stouder, cynthia goyette, kathleen ellis, cathy ferguson	USA	1
sharon wichman	USA	2
sharron davies	GBR	1
shawn crawford	USA	2
shawn crawford, justin gatlin, maurice greene, coby miller	USA	1
sheena tosta	USA	1
sheila echols, florence griffith-joyner, alice brown, evelyn ashford	USA	1
shelley mann	USA	1
shelley mann, nancy simons, sylvia ruuska, joan rosazza	USA	1
shelly-ann fraser	JAM	1
shelly-ann fraser-pryce	JAM	2
shenjie qieyang	CHN	1
shereefa lloyd, shericka williams, novlene williams, rosemarie whyte, bobby-gaye wilkins	JAM	1
shericka williams	JAM	1
sherone simpson	JAM	1
sherri howard, valerie brisco-hooks, chandra cheeseborough	USA	1
shigeo arai	JPN	1
shigeo arai, shigeo sugiura, masahari taguchi, masonori yusa	JPN	1
shirley babashoff	USA	5
shirley babashoff, jane barkman, jennifer kemp, sandra neilson	USA	1
shirley strickland	AUS	3
shirley strickland, fleur mellor, betty cuthbert, norma croker	AUS	1
shirley strong	GBR	1
shiro hashizume	JPN	1
shiwen ye	CHN	2
shouying zhou, xiuhua zhou, xianghua zhang, yali zhang, xiao yang, yadong hu, yaqin han, yanwen he, ronghua li	CHN	1
shozo makino	JPN	2
shumpei uto	JPN	2
sidney atkinson	SAF	2
sidney swann, philip fleming, henry wells, leslie wormwald, stanley garton, angus gillan, ewart horsfall, alister kirby, edgar burgess	GBR	1
sigrun wodars	GDR	1
sileshi sihine	ETH	1
silke h?rner	GDR	2
silken laumann	CAN	2
silvia chiv?s	CUB	1
silvia chiv?s, marlene elejarde, carmen vald?s, fulgencia romay	CUB	1
silvia poll	CRC	1
silvio leonard	CUB	1
simone osygus, bettina ustrowski, daniela brendel, jana d?rries, dagmar hase, daniela hunger, franziska van almsick	GER	1
simone osygus, manuela stellmach, kerstin kielga?, annette hadding, daniela hunger, franziska van almsick	GER	1
simone raineri, alessio sartori, agostino abbagnale, rossano galtarossa	ITA	1
sippy woodhead	USA	1
slavomir knazovicky	SVK	1
s?ndor rozsny?l	HUN	1
s?ndor wlad?r	HUN	1
sofia assefa	ETH	1
solenne figues	FRA	1
sonia o'sullivan	IRL	1
spiridon louis	GRE	1
staciana stitts, courtney shealy, ashley tappin, dara torres, megan quann, bj bedford, jenny thompson, amy van dyken	USA	1
stanislava komarova	RUS	1
stanislawa walasiewicz	POL	2
stanley vickers	GBR	1
stan rowley	AUS	2
stefani werremeier, ingeborg schwerzmann	GER	1
stefan kaplaniak, wladyslaw zielinski	POL	1
stefano baldini	ITA	1
stefano battistelli	ITA	2
stefan pfeiffer	FRG	2
stefan semmler, j?rgen thiele, siegfried brietzke, andreas decker	GDR	1
stefan semmler, wolfgang mager, siegfried brietzke, andreas decker	GDR	1
steffen bogs, heiko habermann, jens k?ppen, steffen z?hlke	GDR	1
steffen zesner, christian tr?ger, oliver lampe, christian keller, aimo heilmann, konstantin dubrovin	GER	1
stefka mihaylova madina, violeta nikolaeva ninova	BUL	1
sten pettersson	SWE	1
stepan oshchepkov, andrey khimich	URS	1
stephan caron	FRA	2
stephan freigang	GER	1
stephanie graf	AUT	1
stephanie rice	AUS	2
stephan moelvig, thor kristensen, eskild ebbesen, thomas ebert	DEN	1
stephan volkert, andr? willms, andreas hajek, marco geisler	GER	1
stephen anderson	USA	1
stephen holland	AUS	1
stephen kipkorir	KEN	1
stephen kiprotich	UGA	1
stephen parry	GBR	1
steve clark, don schollander, roy saari, gary ilman	USA	1
steve cram	GBR	1
steve giles	CAN	1
steve lewis	USA	2
steve lewis, kevin robinzine, butch reynolds, danny everett	USA	1
steve lundquist	USA	1
steve lysack, stephan macknowski	USA	1
steven blaisse, ernst veenemans	NED	1
steven coppola, micah boyd, wyatt allen, josh inman, beau hoopman, bryan volpenhein, daniel walsh, matt schnobrich	USA	1
steven furniss	USA	1
steven genter	USA	2
steven gregg	USA	1
steven redgrave, matthew pinsent	GBR	1
steven redgrave, matthew pinsent, timothy foster, james cracknell	GBR	1
steve ovett	GBR	2
stev theloke	GER	1
st. george ashe	GBR	1
stuart mackenzie	AUS	1
suleiman nyambui	TAN	1
summer sanders	USA	3
sung-yong nam	JPN	1
susan atwood	USA	2
susan francia, anna goodale, erin cafaro, anna cummins, caryn davies, lindsay shoop, carl lind, elle logan	USA	1
susanne gunnarsson-wiberg, agneta andersson	SWE	1
susanne nielsson	DEN	1
susan o'neill	AUS	4
susan pedersen	USA	2
susan pedersen, jan henne, linda gustavson, jane barkman	USA	1
susan rapp	USA	1
susan shields	USA	1
susanthika jayasinghe	SRI	1
suzanne landells	AUS	1
sven malm, agne holmstr?m, william petersson, nils sandstr?m	SWE	1
svetlana babalina	URS	1
svetlana masterkova	RUS	2
svetlana varganova	URS	1
sybil bauer	USA	1
sybille sch?nrock	GDR	1
sylviane felix, muriel hurtis, christine arron, veronique mang	FRA	1
sylvia ruuska	USA	1
sylvi saimo	FIN	1
szilvia szabo, erzsebet viski, rita k?b?n, katalin kovacs	HUN	1
szilvia szabo, katalin kovacs	HUN	1
taehwan park	KOR	2
takashi ishimoto	JPN	1
takashi yamamoto	JPN	1
takashi yokoyama, masonori yusa, hisakichi toyoda, yasuji miyazaki	JPN	1
takeshi matsuda	JPN	2
tamas kiss, gyorgy kozmann	HUN	1
tam?s buday, oszk?r frey	HUN	1
tam?s darnyi	HUN	4
tam?s wichmann	HUN	2
tania dangalakova	BUL	1
tanya lawrence	JAM	1
taoufik makhloufi	ALG	1
tapio kantanen	FIN	1
tariku bekele	ETH	1
tarnee white, dyana calub, leisel jones, susan o'neill, petria thomas, giaan rooney, sarah ryan	AUS	1
tarnee white, emily seebohm, lisbeth trickett, shayne reese, jessicah schipper, felicity galvez, leisel jones	AUS	1
tasha danvers	GBR	1
tatsugo kawaishi	JPN	1
tatsuo fujimoto, makoto fukui, hiroshi ishii, tsuyoshi yamanaka	JPN	1
tatyana anisimova	URS	1
tatyana kazankina	URS	3
tatyana korshunova	URS	1
tatyana ledovskaya	URS	1
tatyana petrova arkhipova	RUS	1
tatyana prorochenko, lyudmila maslakova, nadezhda besfamilnaya, vera anisimova	URS	1
tatyana providokhina	URS	1
tatyana tomashova	RUS	1
tatyana veshkurova, tatiana firova, yulia gushchina, anastasia kapachinskaya, lyudmila litvinova, elena migunova	RUS	1
tebbs lloyd-johnson	GBR	1
tecla marinescu-borcanca, maria stefan-mihoreanu, nastasia ionescu, agafia constantin-buhaev	ROM	1
teddy flack	AUS	2
ted meredith	USA	1
ted murphy, sebastian bea	USA	1
teijiro tanikawa, hiroshi suzuki, toru goto, yoshihiro hamaguchi	JPN	1
teodor kocerka	POL	2
teofilo yldefonzo	PHI	2
terence parkin	RSA	1
terrence trammell	USA	2
terri stickles	USA	1
tesfaye tola	ETH	1
tetiana tereshchuk-antipova	UKR	1
tetsuo hamuro	JPN	1
tetsuo okamoto	BRA	1
tetyana samolenko	URS	1
tetyana semykina, inna osypenko, hanna balabanova, olena cherevatova	UKR	1
teun beijnen, wilhelm r?singh	NED	1
thaddeus shideler	USA	1
thane baker	USA	3
theodore collet	GBR	1
theodore mittet, richard lyon, geoffrey picard	USA	1
theresa andrews	USA	1
therese alshammar	SWE	2
therese zenz	GER	2
therese zenz, ingrid hartmann	GER	1
theresia kiesl	AUT	1
thiago pereira	BRA	1
thomas battersby	GBR	1
thomas bohrer, william burden, jeffrey mclaughlin, patrick manning	USA	1
thomas evenson	GBR	1
thomas fahrner	FRG	1
thomas fahrner, michael gro?, dirk korthals, alexander schowtka	FRG	1
thomas fahrner, michael gro?, erik hochstein, rainer henkel	FRG	1
thomas farrell	USA	1
thomas greiner, ralf brudel, olaf f?rster, roland schr?der	GDR	1
thomas hall	CAN	1
thomas hampson	GBR	1
thomas hicks	USA	1
thomas hill	USA	1
thomas jager	USA	2
thomas jefferson	USA	1
thomas lange	GDR	1
thomas lange	GER	2
thomas lurz	GER	1
thomas mcbreen	USA	1
thomas munkelt	GDR	1
thomas pkemei longosiwa	KEN	1
thomas ponting, mark tewksbury, stephen clarke, marcel gery	CAN	1
thomas price, charles logg	USA	1
thomas reineck, detlef hofmann, olaf winter, mark zabel	GER	1
thomas richards	GBR	1
thomas rupprath, jens kruppa, helge meeuw, steffen driesen, lars conrad	GER	1
thomas strau?, peter van roye	FRG	1
thor henning	SWE	1
thorvald str?mberg	FIN	1
tianfeng si	CHN	1
tibor tatai	HUN	1
tiffany cohen	USA	2
tiki gelana	ETH	1
tim brabants	GBR	3
tim crooks, richard clark, hugh matheson, david maxwell, richard lester, leonard robertson, patrick sweeney, frederick smallbone, john yallop	GBR	1
tim grohmann, lauritz schoof, karl schulze, phillipp wende	GER	1
tim mckee	USA	3
timothy foster, rupert obholzer, greg searle, jonathon searle	GBR	1
timothy kitum	KEN	1
timothy shaw	USA	1
tim wiesk?tter, ronald rauhe	GER	1
tim young, eric mueller, brian jamieson, jason gailes	USA	1
tina dietze, franziska weber	GER	1
tineke lagerberg	NED	1
tinus osendarp	NED	2
tirunesh dibaba	ETH	5
t?nde szab?	HUN	1
todd pearson, adam pine, ian thorpe, chris fydler, ashley callus, michael klim	AUS	1
toimi pitk?nen, veli lehtel?	FIN	1
toivo loukola	FIN	1
tollef tollefsen, adolf nilsen, karl nag, theodor nag, arne mortensen, conrad olsen, thoralf hagen, thore michelsen, haakon ellingsen	NOR	1
tom bruce	USA	1
tom bruce, jerry heidenreich, mark spitz, michael stamm	USA	1
tom burke	USA	2
tom courtney	USA	1
tom curtis	USA	1
tom dolan	USA	3
tom james, andrew triggs hodge, pete reed, alex gregory	GBR	1
tom malchow	USA	2
tommie smith	USA	1
tommy green	GBR	1
tommy karls, lars-erik moberg, thomas ohlsson, per-inge bengtsson	SWE	1
tomomi morita	JPN	1
tom wilkens	USA	1
tonie campbell	USA	1
tonique williams-darling	BAH	1
tonja buford-bailey	USA	1
tonu endrekson, juri jaanson	EST	1
tony dees	USA	1
toos beumer, paulina van der wildt, winnie van weerdeburg, erica terpstra	NED	1
tore sj?strand	SWE	1
torri edwards, chryste gaines, marion jones, nanceen perry, chryste gaines, gail devers, inger miller, gwen torrence	USA	1
torsten gutsche, kay bluhm	GER	1
toshio irie	JPN	1
tove s?by	DEN	1
tracey caulkins	USA	2
tracy cameron, melanie kok	CAN	1
trine hansen	DEN	1
tripp schwenk	USA	1
tsegay kebede	ETH	1
tsutomu oyokota	JPN	1
tsuyoshi yamanaka	JPN	3
tyler clary	USA	1
uchenna emedolu, olusoji fasuba, aaron egbele, deji aliu	NGR	1
ueli bodenmann, beat schwerzmann	SUI	1
ugo frigerio	KIT	1
ulrich eicke	FRG	1
ulrich kons, hans-peter koppe, ulrich karnatz, j?rg friedrich, bernd h?ing, uwe d?hring, jens dobersch?tz, bernd krau?, klaus-dieter ludwig	GDR	1
ulrich papke, ingo spelly	GER	1
ulrike klapezynski	GDR	1
ulrike richter	GDR	2
ulrike tauber	GDR	2
umberto bond?, pietro freschi, paolo gennari, cesare rossi	KIT	1
ursula brunner, christel steffin, gisela wei?, heidi pechstein	GER	1
ursula donath	GER	1
ursula happe	GER	1
usain bolt	JAM	4
usain bolt, michael frater, nesta carter, yohan blake	JAM	1
uta rohl?nder, anja r?cker, linda kisabaka, grit breuer	GER	1
ute geweniger	GDR	1
uwe da?ler	GDR	2
uwe da?ler, thomas flemming, sven lodziewski, steffen zesner	GDR	1
vadim yaroshchuk	URS	1
?va d?nusz, rita k?b?n	HUN	1
vadzim makhneu, raman piatrushenka	BLR	1
valentina yegorova	RUS	1
valentina yegorova	URS	1
valentin boreyko, oleg golovanov	URS	1
valentin massana	ESP	1
valeria bufanu	ROM	1
valerie brisco-hooks	USA	2
valerie brisco-hooks, florence griffith-joyner, denean howard-hill	USA	1
valerio arri	KIT	1
valeriy borchin	RUS	1
valery borzov	URS	3
valery dolinin, aleksey kamkin, aleksandr kulagin, vitaly yeliseyev	URS	1
val?ria gyenge	HUN	1
vanderlei lima	BRA	1
vanja gesheva-tsvetkova	BUL	2
vanja gesheva-tsvetkova, borislava ivanova, diana paliyska, ognyana petkova	BUL	1
?va nov?k	HUN	3
?va nov?k, ilona nov?k, katalin sz?ke, judit temes	HUN	1
?va rakusz, m?ria zakari?s	HUN	1
vasile diba	ROM	3
vasileios polymeros, dimitros mougios	GRE	1
vasily arkhipenko	URS	1
vasily yakusha	URS	1
vasily yakusha, aleksandr marchenko	URS	1
vasily yurchenko	URS	1
?va sz?kely	HUN	2
v?clav chalupa	CZR	1
v?clav koz?k, pavel schmidt	CZE	1
vebj?rn rodal	NOR	1
veenhoven, kingma, achterberg, de groot, repelaer van driel, belderbos, bouw, de haan, schellekens	NED	1
veikko karvonen	FIN	1
veniamin soldatenko	URS	1
venuste niyongabo	BDI	1
vera cochelea, elisabeta lipa	ROM	1
vera komisova	URS	1
vera tanner, constance jeans, grace mckenzie, florence barker	GBR	1
veronica campbell	JAM	3
veronica campbell, aleen bailey, sherone simpson, tanya lawrence	JAM	1
veronica campbell-brown	JAM	1
veronica campbell-brown, sherone simpson, kerron stewart, shelly-ann fraser-pryce	JAM	1
vicente lima, andr? silva, edson ribeiro, claudinei da silva	BRA	1
victor davis	CAN	2
viktor denisov, aleksandr motuzenko, igor nagayev, sergey kirsanov	URS	1
viktor denisov, igor nagayev	URS	1
viktor flessl, leo losert	AUT	1
viktor kakoshin, grigory dmitrenko, andrey tishchenko, aleksandr tkachenko, jonas pinskus, jonas narmontas, aleksandr matsevich, igor maystrenko, andrey lugin	URS	1
viktor kuznetsov	URS	1
viktor markin	URS	1
viktor mazanov, igor grivennikov, georgi kulikov, vladimir bure	URS	1
viktor mazanov, leonid ilyichov, georgi kulikov, semyon belitz-geyman	URS	1
viktor mazanov, vladimir bure, viktor aboimov, igor grivennikov	URS	1
viktor reneysky, nikola? juravschi	MDA	1
viktor reneysky, nikola? juravschi	URS	2
ville ritola	FIN	5
vilma egresi, kl?ra fried-b?nfalvi	HUN	1
vincent duncker	DEU	1
vincent matthews	USA	1
violeta szekely	ROM	1
violetta quesada, fulgencia romay, miguelina cobi?n, marlene elejarde	CUB	1
viorica dumitru	ROM	1
viorica dumitru, maria nichiforov	ROM	1
viorica susanu, georgeta andrunache	ROM	1
virginia duenkel	USA	2
virginia lee, rebecca joyce	AUS	1
vitaly galkov	URS	1
vitaly savin, vladimir muravyov, vladimir krylov, viktor bryzgin	URS	1
vitaly sorokin, vladimir struzhanov, boris nikitin, gennady nikolayev	URS	1
vivian cheruiyot	KEN	2
vladek lacina, zdenek pecka, jaroslav hellebrand, v?clav vochoska	CZE	1
vladimir andreyev	RUS	1
vladimir bure	URS	1
vladimir dolgov	URS	1
vladimir golubnichy	URS	4
vladimir kazantsev	URS	1
vladimir kosinsky	URS	2
vladimir kuts	URS	2
vladimir morozov, aleksandr shaparenko	URS	1
vladimir parfenovich	URS	1
vladimir parfenovich, sergey chukhray	URS	1
vladimir raskatov	URS	1
vladimir rodimushkin, yevgeny samsonov, igor polyakov, slava amiragov, yevgeny brago, igor borisov, leonid gissen, vladimir kryukov, aleksey komarov	URS	1
vladimir salnikov	URS	3
vladimir selkov	URS	1
vladimir selkov, aleksandr popov, stanislav lopukhov, denis pankratov, roman ivanovskiy, vladislav kulikov, roman yegorov	RUS	1
vladimir sukharyev, boris tokarev, leonid bartenev, yuri konovalov	URS	1
vladimir sukharyev, levan sanadse, boris tokarev, levan kalyaev	URS	1
vladimir volodenkov, dmitriy rozinkevich, roman monchenko, pavel melnikov, sergey matveyev, andrey glukhov, aleksandr lukyanov, nikolay aksyonov, anton chermashentsev	RUS	1
vladim?r andrs, pavel hofman	CZE	1
vladislav kulikov	RUS	1
voitto hellst?n	FIN	1
volker beck	GDR	1
volmari iso-hollo	FIN	4
voula patoulidou	GRE	1
vyacheslav ivanenko	URS	1
vyacheslav ivanov	URS	3
waldemar cierpinski	GDR	2
wallace o'connor, harrison glancy, ralph breyer, johnny weissmuller	USA	1
wallace wolf, william smith, walter ris, james mclane	USA	1
wally kinnear	GBR	1
walter dix	USA	2
walter laufer	USA	1
walter mahlendorf, martin lauer, bernd cullmann, armin hary	GER	1
walter rangeley	GBR	1
walter ris	USA	1
walter tewksbury	USA	3
walther bathe	DEU	1
warren kealoha	USA	2
warren weir	JAM	1
wayne collett	USA	1
wayne frye, william fields, robert detweiler, james dunbar, charles manring, richard murphy, henry proctor, frank shakespeare, edward stevens	USA	1
wendell mottley	TRI	1
wendell mottley, edwin skinner, edwin roberts, kent bernard	TRI	1
wendy boglioli	USA	1
wendy weinberg	USA	1
wenyi yang	CHN	2
werner lampe	FRG	1
werner lueg	GER	1
whitney hedgepeth	USA	2
wieger mensonides	NED	1
wilfred bungei	KEN	1
wilfried hartung, peter bruch, roland matthes, lutz unger	GDR	1
wilhelmina von bremen	USA	1
william burden, seth bauer, jonathan smith, michael teti, john rusher, ted patton, john pescatore, jeffrey mclaughlin, peter nordell	USA	1
william crothers	CAN	1
william dally, peter donlon, francis frederick, donald blessing, john brinck, hubert caldwell, marvin stalder, james workman, william thompson	USA	1
william forrester	USA	1
william frank	USA	1
william gilmore	USA	1
william gilmore, kenneth myers	USA	1
william harris	USA	1
william holland	USA	1
william jordan, edward moore, alden sanborn, virgil jacomini, edwin graves, clyde king, donald johnston, vincent gallagher, sherman clark	USA	1
william kirschbaum	USA	1
william knecht, william stowe, stanley cwiklinski, harold budd, joseph amlong, thomas amlong, emory clark, hugh foley, r?bert zimonyi	USA	1
william maher, john nunn	USA	1
william miller	USA	1
william miller, charles karle, george heales, ernest bayer	USA	1
william mutwol	KEN	1
william nichol, harold abrahams, lancelot royle, walter rangeley	GBR	1
william porter	USA	1
william robinson	GBR	1
william sherring	CAN	1
william smith	USA	1
william tanui	KEN	1
william varley, john mulcahy	USA	1
william verner	USA	1
william yorzyk	USA	1
willie applegarth	GBR	1
willie davenport	USA	2
willie den ouden	NED	1
willie may	USA	1
willy l?tzow	DEU	1
willy sch?rer	SUI	1
wilma rudolph	USA	2
wilma rudolph, margaret matthews, isabelle daniels, mae faggs, janet moreau, barbara jones, catherine hardy, mae faggs	USA	1
wilma van rijn, manon van rooijen, inge de bruijn, chantal groot, thamar henneken	NED	1
wilson boit kipketer	KEN	1
wilson kipketer	DEN	2
wilson kiprugut	KEN	2
wilson kipsang kiprotich	KEN	1
wiltrud urselmann	GER	1
wim slijkhuis	NED	2
wim van der kroft, nico tates	NED	1
winona zimmerman	USA	1
winthrop graham	JAM	1
winthrop graham, trevor grahem, bert cameron, howard davis, devon morris	JAM	1
wolfgang g?ldenpfennig	GDR	1
wolfgang hottenrott, michael schwan	GER	1
wolfgang mager, siegfried brietzke	GDR	1
wu you, gao yulan	CHN	1
wyndham halswelle	GBR	3
wyomia tyus	USA	2
wyomia tyus, marilyn white, willye white, edith mcguire	USA	1
xavier dorfman, jean-christophe bette, yves hocde, laurent porchier	FRA	1
xenia stad-de jong, gerda van der kade-koudijs, nettie witziers-timmer, fanny blankers-koen	NED	1
xeno m?ller	SUI	2
xi aihua, tang bin, jin ziwei, zhang yangyang	CHN	1
xiang liu	CHN	1
xiaohong wang	CHN	1
xiaomin huang	CHN	1
ximena restrepo	COL	1
xiuyun zhang, mianying cao	CHN	1
xuanxu li	CHN	1
xuejuan luo	CHN	1
xu tianlongzi, zhou yafei, sun ye, pang jiaying, zhao jing	CHN	1
yana dementyeva, kateryna tarasenko, anastasiia kozhenkova, nataliya dovgodko	UKR	1
yana klochkova	UKR	5
yang sun	CHN	3
yang sun, yun hao, haiqi jiang, yunqi li	CHN	1
yannick agnel	FRA	1
yasuji miyazaki	JPN	1
yasuko tajima	JPN	1
yekaterina khodotovich	BLR	3
yelena dendeberova	URS	1
yelena khloptseva, yekaterina khodotovich, tatyana ustyuzhanina, antonina zelikovich	URS	1
yelena kruglova, alla grishchenkova, natalya strunnikova, elvira vasilkova	URS	1
yelena rudkovskaya	URS	1
yelena zhupiyeva	URS	1
yelyzaveta bryzgina, olesya povh, mariya ryemyen, hrystyna stuy	UKR	1
yevgeny arzhanov	URS	1
yevgeny gavrilenko	URS	1
yevgeny ivchenko	URS	1
yevgeny maskinsov	URS	1
yevgeny penyaev	URS	1
yevgeny sadovyi	URS	2
yevgeny seredin, sergey koplyakov, viktor kuznetsov, arsen miskarov	URS	1
ying lu	CHN	1
ying shan, huijue cai, yan chen, xue han	CHN	1
yi tang	CHN	1
yohan blake	JAM	2
yong zhuang	CHN	3
yong zhuang, wenyi yang, kun zhao, jingyi le, bin lu	CHN	1
yordanka donkova	BUL	2
yoshihiko osaki	JPN	1
yoshihiro okumura, tomomi morita, kosuke kitajima, takashi yamamoto	JPN	1
yoshinobu oyakawa	USA	1
yoshiyuki tsuruta	JPN	2
young-cho hwang	KOR	1
yrj? hietanen, kurt wires, lars glass?r, ingemar hedberg	SWE	1
yrj? kolehmainen	FIN	1
yuko arimori	JPN	2
yuko nakanishi	JPN	1
yulia sotnikova, irina privalova, olga kotlyarova, svetlana gontcharenko	RUS	1
yuliya bichyk, natallia helakh	BLR	1
yuliya bogdanova	URS	1
yuliya nesterenko	BLR	1
yuliya ryabchynskaya	URS	1
yuliya zaripova	RUS	1
yunxia qu	CHN	1
yuri lituyev	URS	1
yuriy borzakovskiy	RUS	1
yuriy cheban	UKR	2
yury bachurov, igor akhremchik, valentin morkovkin, anatoly tarabrin	URS	1
yury bashkatov, nikolay yevseyev, vladimir tkachenko, gennady prigoda	URS	1
yury lobanov, vasily yurchenko	URS	1
yury lobanov, vladislavas cesiunas	URS	1
yury lorentson, juozas jagelavicius, valentin kravchuk, vladimir sterlik, viktor suslin, aleksandr martyshkin, antanas bagdonavicius, vytautas briedis, zigmas jukna	URS	1
yury malyshev	URS	1
yury postrigay, alexander dyachenko	RUS	1
yury stetsenko, valery didenko, yury filatov, vladimir morozov	URS	1
yury tyukalov	URS	1
yury yakimov, vytautas butkus, yevgeny duleyev, aivars lazdenieks	URS	1
zachary zorn, kenneth walsh, mark spitz, stephen rerych	USA	1
zac purchase, mark hunter	GBR	1
zbigniew jaremski, jerzy pietrzyk, ryszard podlas, jan werner	POL	1
zdenek pecka, v?clav vochoska	CZE	1
zdzislaw krzyszkowiak	POL	1
zersenay tadesse	ERI	1
zhang lin	CHN	1
zhen wang	CHN	1
zhou chunxiu	CHN	1
zoltan kammerer, botond storcz	HUN	1
zoltan kammerer, tamas kulifai, daniel pauman, david toth	HUN	1
zolt?n bak?, istv?n szab?	HUN	1
zolt?n sztanity	HUN	1
zolt?n verraszt?	HUN	2
zolt?n von halmay	HUN	3
zolt?n von halmay, b?la von las torres, imre zach?r, j?zsef munk	HUN	1
zoran pancic, milorad stanulov	YUG	2
zsolt gyulai	HUN	2
zsolt gyulai, s?ndor h?dosi, ferenc csipes, attila ?brah?m	HUN	1
zuzana hejnova	CZE	1
